socialNbFollowers,socialNbFollows,socialProductsLiked,productsListed,productsSold,productsPassRate,productsWished,productsBought,social,products,country,daysSinceLastLogin,x,y,kmeans,spectral,aggl
31,8,0,1,1,0.0,0,1,39,0,France,127,0.2206535554447367,0.42797712672265886,1,3,0
7,8,6,1,1,0.0,0,0,15,6,France,485,0.11828655069799329,-0.3423432974834539,3,0,2
10,8,0,0,3,66.0,0,0,18,0,UK,665,0.5306935507133671,1.303514439109882,2,3,0
3,8,0,0,1,0.0,0,0,11,0,France,405,1.8211872325051162,-0.5087243978983337,1,3,3
16,0,6,0,1,0.0,303,32,16,309,UK,20,0.12392511510043193,-1.5143377242073035,3,2,2
8,8,0,4,3,100.0,0,0,16,0,Finland,82,0.18658635434823742,1.920554290974352,2,3,0
5,8,6,0,1,0.0,223,3,13,229,Hong Kong,16,-0.3093130037344521,-1.9877613394887381,3,0,2
29,8,33,2,2,100.0,17,8,37,50,Netherlands,377,-1.6010977364637862,0.08429624163822214,0,0,1
5,8,1,0,2,0.0,0,0,13,1,Germany,192,0.28090550359648103,-0.14637416346417056,3,0,2
16,9,373,0,5,0.0,47,7,25,420,UK,362,-1.2540254256566565,-1.2476848314395526,0,0,1
26,9,1,3,1,0.0,1,0,35,2,Italy,15,-0.6642096762950999,-0.4527867883851335,3,0,2
11,8,23,0,3,100.0,0,0,19,23,Sweden,87,-0.4545249676859688,0.6935319864866241,2,0,1
6,8,0,5,1,0.0,0,0,14,0,Netherlands,16,0.8930755217867159,0.5476913776895764,1,3,0
5,15,3,0,1,0.0,8,1,20,11,France,166,-0.6270988905207142,-1.7132894472980231,3,0,2
3,8,1,0,1,0.0,0,0,11,1,France,591,1.1451057199666888,-1.3217155607992037,3,0,3
3,9,7,4,3,66.0,1,0,12,8,Italy,23,-0.26411404563186086,-0.5576212537320139,3,0,3
3,8,0,0,1,0.0,0,0,11,0,France,27,1.8211872325051162,-0.5087243978983337,1,3,3
6,8,0,0,1,0.0,0,0,14,0,US,681,1.1552922511386405,0.2014957695955509,1,3,0
7,8,3,2,2,100.0,0,0,15,3,US,27,-0.4568871281124744,0.9588112034297437,2,0,1
15,8,7,10,4,50.0,0,0,23,7,France,12,-0.6120988316265751,0.8702091113339395,2,0,1
42,16,31,9,11,90.0,3,5,58,34,US,21,-1.9016000381554765,-0.035467275727857024,0,0,1
30,8,0,0,1,0.0,0,0,38,0,US,578,0.725380003113634,0.6056067220600782,1,3,0
20,8,8,1,1,0.0,0,0,28,8,US,111,-0.1633006315491042,-0.10353647806255446,3,0,2
5,8,20,1,1,0.0,0,0,13,20,US,93,0.2004241812892282,-0.5312821851740509,3,0,2
3,8,1,0,1,0.0,0,0,11,1,France,707,1.1451057199666888,-1.3217155607992037,3,0,3
5,8,3,1,1,0.0,0,0,13,3,France,153,0.28080513455466344,-0.43464540632237936,3,0,2
28,11,12,0,1,0.0,3,57,39,15,Italy,11,-0.9744077878992342,-1.5483685874022208,0,0,2
11,8,48,4,7,100.0,1,2,19,49,France,11,-1.3722041857289313,0.08241180155703479,0,0,1
10,14,42,0,1,0.0,5,1,24,47,Germany,85,-0.8269861359558653,-1.687908837981955,3,0,2
12,8,13,12,16,100.0,4,0,20,17,Australia,24,-1.1325754720289545,0.7434628921128035,0,0,1
20,9,0,0,2,0.0,0,0,29,0,Germany,298,0.380774234259905,0.973843291559788,1,3,0
3,9,38,4,1,0.0,33,3,12,71,France,16,-0.24198155428887297,-2.212738748203768,3,0,3
10,48,191,0,1,0.0,11,6,58,202,Netherlands,12,-1.2260557870141722,-1.7644366841730628,0,0,2
6,12,0,0,1,0.0,1,1,18,1,Italy,488,-0.15187023729256902,-1.1844892565245828,3,0,2
16,10,25,1,5,100.0,2,0,26,27,UK,11,-1.3525422677750574,0.5554323472824056,0,0,1
5,8,2,25,4,75.0,0,0,13,2,France,11,-0.245935655209987,0.6517626398712415,2,0,1
3,10,30,0,1,0.0,8,0,13,38,France,34,0.22073984984571007,-1.9262307545123905,3,0,3
25,30,410,3,2,100.0,45,2,55,455,Spain,11,-2.1348111012799795,-0.1544362835008558,0,0,1
15,8,0,18,14,100.0,0,0,23,0,UK,29,-0.06315590801188901,2.220705901761163,2,3,0
9,8,0,6,8,0.0,0,0,17,0,UK,665,0.4303261846671514,1.3108254720127686,2,3,0
3,8,1,0,1,0.0,0,0,11,1,France,691,1.1451057199666888,-1.3217155607992037,3,0,3
6,8,0,1,4,50.0,0,0,14,0,France,62,0.4651208449560289,1.456739034434605,2,3,0
137,13,60,33,163,94.0,10,3,150,70,France,11,-2.24267694596326,0.35907224347978284,0,0,1
4,8,9,0,1,0.0,0,2,12,9,UK,642,0.29697458178493547,-1.4039870500460152,3,0,2
4,8,0,1,2,0.0,1,0,12,1,Spain,600,0.17998862761312223,-0.013059474209417218,3,0,1
6,8,2,0,1,0.0,0,0,14,2,Sweden,188,0.45056531843509934,-0.6459037166653305,3,0,2
24,8,0,0,5,100.0,0,0,32,0,France,12,0.15980974003937656,1.8659345880276674,2,3,0
5,11,0,2,1,0.0,0,0,16,0,France,540,0.6204447484788526,0.44056115535540985,1,3,0
4,9,0,3,2,100.0,3,1,13,3,France,31,-0.7103657914705542,0.17931466996959222,0,0,1
25,8,0,0,2,0.0,0,0,33,0,Spain,695,0.5019139310122246,1.0953062901736415,1,3,0
4,8,8,0,1,0.0,1,0,12,9,Chypre,29,0.26208896259368336,-1.3415368608844151,3,0,2
7,8,1,2,12,83.0,0,1,15,1,France,14,-0.5971913498672092,0.3222344664691209,2,0,1
4,9,123,1,1,0.0,0,1,13,123,France,28,-0.2955255864482511,-1.2527168590455577,3,0,2
21,8,17,0,2,100.0,1,0,29,18,UK,455,-0.8861504187352403,0.365538150291886,0,0,1
71,9,22,0,18,66.0,14,11,80,36,Netherlands,14,-1.6089752866469182,-0.3193398657820831,0,0,1
6,10,36,5,1,0.0,1,1,16,37,Italy,11,-0.8124602531840649,-1.4291429154854014,3,0,2
25,8,1,0,4,75.0,0,0,33,1,Italy,12,-0.3705204038755182,0.716347572443781,2,0,1
6,8,0,0,1,0.0,0,0,14,0,France,612,1.1552922511386405,0.2014957695955509,1,3,0
3,8,0,2,1,0.0,0,0,11,0,France,217,1.5799460760545474,-0.19022210759395686,1,3,3
21,9,11,19,12,100.0,0,7,30,11,France,16,-1.3758915175919741,0.7229759187275636,0,0,1
9,8,5,3,1,100.0,1,0,17,6,UK,236,-0.6143876694399985,0.03212694742103914,0,0,1
6,8,107,0,1,0.0,3,0,14,110,Italy,28,-0.06622261178328123,-1.3390590474339998,3,0,2
25,8,0,0,2,100.0,0,0,33,0,France,319,0.1842071424532456,1.8092988262659724,2,3,0
7,8,0,0,7,100.0,0,0,15,0,France,11,0.4628210773959801,1.5903806715959745,2,3,0
7,8,1,0,1,0.0,0,0,15,1,Italy,666,0.4194671292710171,-0.5552771617958512,3,0,2
4,9,334,0,2,0.0,1,4,13,335,Italy,34,-0.7367801938552596,-1.5783395633944393,3,0,1
7,8,0,0,3,66.0,0,0,15,0,UK,61,0.6394881116780596,1.2009368509389096,2,3,0
4,13,142,0,1,0.0,2,6,17,144,Spain,11,-0.6924796430894862,-2.011006854143516,3,0,2
4,8,26,0,1,0.0,1,0,12,27,France,233,0.2106840768509623,-1.4033534950260305,3,0,2
3,9,0,1,1,0.0,0,0,12,0,France,76,1.2965149917193004,-0.1780780929311491,1,3,3
30,8,0,7,4,100.0,0,0,38,0,Chypre,17,-0.16063468373496645,2.2618213758953645,2,3,0
8,8,475,1,1,0.0,11,10,16,486,Germany,11,-0.8165398126204554,-1.6359389432382268,3,0,2
26,8,0,3,5,40.0,0,0,34,0,Italy,271,0.046508910207446214,1.8652023259895898,2,3,0
40,9,51,1,6,0.0,7,33,49,58,Germany,14,-1.5666086826003833,-0.6301461984343405,0,0,1
11,8,0,1,2,0.0,0,0,19,0,UK,419,0.4592935139871557,1.2217624326092587,2,3,0
42,8,0,55,54,100.0,0,0,50,0,UK,23,-0.3556186992167668,2.547988754512359,2,3,0
5,8,0,0,1,0.0,0,0,13,0,UK,54,1.2296015562652716,0.13122512192593444,1,3,0
23,8,0,0,4,100.0,0,0,31,0,France,367,0.1790919630016701,1.8404022787686043,2,3,0
3,8,0,0,1,0.0,0,0,11,0,France,380,1.8211872325051162,-0.5087243978983337,1,3,3
25,8,0,0,4,100.0,0,0,33,0,Italy,147,0.15867059160626984,1.8594504502276796,2,3,0
6,8,14,1,1,0.0,11,1,14,25,UK,11,-0.49377786080992553,-1.4491281020427944,3,0,2
7,8,0,0,1,0.0,0,0,15,0,Germany,654,1.0955486418094444,0.2577140011050198,1,3,0
3,8,0,0,2,100.0,0,0,11,0,France,534,1.230865903815774,0.7406600157047636,1,3,3
44,8,14,0,18,78.0,9,3,52,23,Italy,61,-1.3073069424501107,-0.2266337051391503,0,0,1
4,8,51,2,2,100.0,27,1,12,78,France,17,-0.986769150670396,-0.4531917136960109,0,0,1
7,8,2,8,4,75.0,1,0,15,3,France,21,-0.6758270001665224,0.28230208871969936,0,0,1
17,8,5,1,4,100.0,0,0,25,5,France,53,-0.7272119389662824,1.1894265436173528,2,0,1
4,8,0,0,3,100.0,0,0,12,0,France,610,0.735951246556057,1.3053603161256235,2,3,0
6,8,0,0,1,0.0,0,0,14,0,France,657,1.1552922511386405,0.2014957695955509,1,3,0
9,8,808,3,1,0.0,5,16,17,813,US,13,-0.9070758227348664,-1.6178164479606507,3,0,2
3,9,30,0,1,0.0,0,0,12,30,Finland,13,0.703313576785198,-1.4663383715362186,3,0,3
4,8,0,0,2,0.0,13,0,12,13,Germany,252,0.3143340642195788,-0.4371630785281831,3,0,1
41,8,0,23,43,78.0,0,0,49,0,France,11,-0.1775543889653245,2.1758003602666185,2,3,0
7,8,0,0,1,0.0,0,1,15,0,US,670,0.8279118201684204,-0.22988848239912968,1,3,0
12,8,5,1,13,100.0,0,0,20,5,Monaco,19,-0.6878116510040178,1.191392353709745,2,0,1
27,8,0,3,2,0.0,0,0,35,0,Spain,444,0.2340329489059815,1.4420521297830078,2,3,0
3,8,0,0,1,0.0,0,0,11,0,France,707,1.8211872325051162,-0.5087243978983337,1,3,3
3,8,1,3,1,0.0,0,0,11,1,Italy,34,0.8952545751914595,-0.9918458030143769,3,0,3
5,8,0,0,1,0.0,0,0,13,0,US,704,1.2296015562652716,0.13122512192593444,1,3,0
6,8,0,0,1,0.0,0,0,14,0,Spain,689,1.1552922511386405,0.2014957695955509,1,3,0
6,8,20,6,9,88.0,10,0,14,30,Italy,13,-0.7746584848159039,0.10966295175035684,0,0,1
24,8,1,3,3,100.0,1,0,32,2,UK,424,-1.079306935927305,0.8828420150989085,0,0,1
7,8,1,0,3,100.0,0,0,15,1,France,407,-0.18649555355551248,0.7248255471495083,2,0,1
7,8,14,0,9,88.0,0,1,15,14,France,25,-0.4565897222156997,-0.14068646844885624,2,0,1
43,8,5,1,4,0.0,0,0,51,5,Italy,448,-0.6147110489808933,0.6699313678194915,2,0,1
20,8,0,0,1,0.0,0,0,28,0,Spain,264,0.8261692431966401,0.5112159095950021,1,3,0
12,8,0,1,2,0.0,0,0,20,0,UK,62,0.4357854572733043,1.2439766939744135,2,3,0
23,10,67,2,5,60.0,6,3,33,73,Denmark,19,-1.6414492137252574,-0.3054048077478364,0,0,1
48,16,599,22,82,89.0,1016,32,64,1615,Germany,11,-2.361929463243437,-0.3247805610895819,0,0,1
3,8,7,0,1,0.0,0,0,11,7,Denmark,43,1.0654312860744515,-1.4174186489287302,3,0,3
3,8,3,0,1,0.0,16,0,11,19,Germany,171,0.6984896091437165,-1.9382422087068967,3,0,3
8,8,0,0,1,0.0,0,0,16,0,Austria,130,1.0497295573481775,0.3009051053742676,1,3,0
46,192,274,22,9,88.0,47,0,238,321,Italy,11,-2.117257022299691,0.3829949471893887,0,0,1
30,8,0,1,3,100.0,0,0,38,0,Italy,301,-0.1085058166414964,2.1866284043398734,2,3,0
3,8,0,0,1,0.0,0,0,11,0,France,48,1.8211872325051162,-0.5087243978983337,1,3,3
9,8,9,0,4,100.0,2,3,17,11,UK,29,-0.9833311133492657,-0.27714492053619644,0,0,1
5,8,0,0,1,0.0,0,0,13,0,Germany,706,1.2296015562652716,0.13122512192593444,1,3,0
3,8,32,2,1,0.0,40,4,11,72,Germany,13,0.06730779325457054,-2.271452249619876,3,0,3
3,8,3,1,1,0.0,0,0,11,3,Denmark,55,0.8723908107945082,-1.0745949261466468,3,0,3
79,421,1751,4,10,77.7,299,0,500,2050,Spain,55,-2.331515508169044,0.18339453364532624,0,0,1
4,8,0,6,1,0.0,0,0,12,0,Italy,13,1.075736473982669,0.3766824238227597,1,3,0
3,8,0,0,1,0.0,0,0,11,0,France,698,1.8211872325051162,-0.5087243978983337,1,3,3
21,8,0,0,2,100.0,0,0,29,0,France,546,0.2254827192470021,1.7705444769131986,2,3,0
4,8,16,1,1,0.0,0,0,12,16,France,20,0.32261744692058014,-0.6253471499604949,3,0,2
4,8,11,0,1,0.0,0,0,12,11,France,34,0.5684078948964045,-0.904783453833068,3,0,2
27,12,4,1,1,0.0,0,0,39,4,US,209,-0.49212233174425907,-0.10245103287376822,3,0,2
4,12,5,4,4,100.0,11,0,16,16,Italy,11,-1.1170674422779023,0.2868461851787363,0,0,1
8,20,9,4,3,66.0,141,3,28,150,Portugal,32,-1.6563989371843832,-0.5258643510542921,0,0,1
10,9,35,8,10,100.0,14,0,19,49,Spain,12,-1.314926268022335,0.49497057543312806,0,0,1
3,8,0,0,1,0.0,0,0,11,0,France,11,1.8211872325051162,-0.5087243978983337,1,3,3
5,8,0,0,6,83.0,0,0,13,0,France,45,0.7450409540053227,1.1322350279496767,2,3,0
9,8,1,0,1,0.0,1,0,17,2,UK,707,0.008631232753039914,-0.9454722549639203,3,0,2
5,7,0,0,1,0.0,0,0,12,0,France,676,1.576407550328933,0.19238382440277715,1,3,2
19,8,1,15,30,83.0,0,1,27,1,Italy,13,-0.9323266697302384,0.6852767793803078,0,0,1
4,8,60,0,3,66.0,1,0,12,61,Austria,53,-0.28777971988420065,-0.5110611251555918,3,0,1
9,8,7,21,5,100.0,12,0,17,19,Italy,11,-1.0387106381704525,0.5964496885714697,0,0,1
24,9,0,2,3,0.0,0,0,33,0,UK,227,0.08148052785711593,1.3632060517318487,2,3,0
4,8,4,0,1,0.0,0,0,12,4,France,72,0.6087700080331384,-0.8562572957047054,3,0,2
3,8,4,1,1,0.0,2,0,11,6,Italy,90,0.5254568972267877,-1.5625485824404812,3,0,3
36,15,3,0,9,100.0,1,0,51,4,US,304,-1.3033623774611784,0.5486893252962589,0,0,1
22,9,1,0,1,0.0,0,0,31,1,US,695,-0.04403963202599274,-0.3542314628027893,3,0,2
8,8,5,0,2,100.0,3,0,16,8,UK,369,-0.6251954972537537,0.17400019622544605,0,0,1
52,44,73,15,19,100.0,3,3,96,76,UK,13,-2.250596560218907,0.3232892253617877,0,0,1
12,8,133,2,4,100.0,0,4,20,133,UK,12,-1.113410418784717,0.41120766148709786,0,0,1
27,8,24,0,1,0.0,0,0,35,24,France,62,-0.05402430392502575,-0.3977966954281119,3,0,2
9,8,0,0,1,0.0,0,0,17,0,US,705,1.0151362757601352,0.3336331340255293,1,3,0
3,4,4,0,1,0.0,1,6,7,5,Netherlands,81,0.9863590805043371,-2.4412015123541377,3,0,3
10,8,0,0,2,100.0,0,0,18,0,US,618,0.39643275215540963,1.6096760028790897,2,3,0
43,23,894,3,8,62.5,290,174,66,1184,US,11,-2.2670578075084813,-0.610872245337648,0,0,1
11,16,21,0,1,0.0,28,2,27,49,Australia,11,-0.8973854288314848,-1.7094635022925797,3,0,2
8,8,1,0,1,0.0,2,0,16,3,Netherlands,47,0.0251733179139442,-1.0023619822873524,3,0,2
4,8,0,2,1,0.0,0,1,12,0,UK,17,0.8330359512909928,-0.14384258601950858,1,3,0
5,9,0,0,1,0.0,0,0,14,0,UK,132,1.0117480335209152,0.09572504937480913,1,3,0
46,41,70,0,1,0.0,67,5,87,137,Hong Kong,258,-1.3487754924551172,-1.5825535129188346,0,0,2
4,8,1,1,2,0.0,0,0,12,1,France,597,0.16529473978519527,0.04857729512459516,3,0,1
26,8,0,4,10,100.0,0,0,34,0,Spain,36,-0.13665651882192456,2.264096909058601,2,3,0
3,8,0,0,1,0.0,0,0,11,0,UK,102,1.8211872325051162,-0.5087243978983337,1,3,3
22,8,16,0,4,75.0,0,1,30,16,UK,181,-0.7216714368859829,0.06059561037569307,0,0,1
5,8,0,0,1,0.0,0,0,13,0,France,383,1.2296015562652716,0.13122512192593444,1,3,0
3,8,1,2,2,100.0,0,0,11,1,France,647,0.31354323482677754,0.24617114310826957,2,0,3
4,8,3,1,2,100.0,0,0,12,3,France,47,-0.19720382101736358,0.7087714925350475,2,0,1
3,8,0,0,1,0.0,0,0,11,0,France,695,1.8211872325051162,-0.5087243978983337,1,3,3
4,8,1,0,1,0.0,0,0,12,1,France,666,0.6658324168441594,-0.7877335557206065,3,0,2
29,8,12,0,6,100.0,8,4,37,20,Spain,14,-1.320681706815836,-0.05602917255362383,0,0,1
58,34,148,22,10,100.0,2,3,92,150,Italy,11,-2.2569819172539267,0.2681938712628419,0,0,1
5,8,64,2,4,75.0,0,4,13,64,Denmark,25,-0.631711457456432,-0.1454443608970971,0,0,1
12,8,3,0,6,66.0,3,0,20,6,France,372,-0.6091288579938364,0.03865000998805211,0,0,1
37,9,122,23,27,85.0,0,0,46,122,Italy,11,-1.2163061669600217,0.9884597422127793,0,0,1
15,8,6,7,11,100.0,44,1,23,50,France,13,-1.4781335520756462,0.18929963145034243,0,0,1
4,8,0,3,1,0.0,0,0,12,0,Italy,516,1.0920627846073574,0.3551273649650917,1,3,0
27,10,10,0,1,0.0,0,0,37,10,Italy,601,-0.24110588251063308,-0.4375262291031323,3,0,2
7,8,0,3,4,60.0,0,0,15,0,Spain,12,0.38164795876930446,1.5459560993364168,2,3,0
49,35,1,0,4,100.0,0,0,84,1,Italy,18,-1.0684722107961533,1.0606791068421406,0,0,1
8,9,2,3,2,0.0,0,0,17,2,France,41,-0.3675074318882954,0.2602757961004523,2,0,1
15,19,0,5,2,0.0,149,22,34,149,UK,12,-1.2270608673540855,-0.4606867743308919,0,0,1
4,8,18,0,1,0.0,5,3,12,23,Spain,114,-0.08741868282256508,-1.9443994834931542,3,0,2
35,11,8,2,27,55.0,1,0,46,9,Netherlands,30,-1.4027316515181472,0.55778934049265,0,0,1
9,11,10,10,6,50.0,0,0,20,10,France,661,-0.8046591158890881,0.6875824926718823,2,0,1
37,11,143,2,5,60.0,14,2,48,157,Sweden,17,-1.8257719868781197,-0.2811467743580905,0,0,1
8,8,1,0,1,0.0,1,1,16,2,France,634,-0.22441230729994216,-1.4658027671193317,3,0,2
6,8,1,0,1,0.0,0,0,14,1,France,584,0.4792107386002132,-0.6114953933053199,3,0,2
3,8,0,2,1,0.0,0,0,11,0,Italy,11,1.5799460760545474,-0.19022210759395686,1,3,3
42,8,1,22,11,90.0,1,0,50,2,Italy,25,-1.152598900942286,0.832018587229266,0,0,1
13,8,0,3,3,100.0,0,0,21,0,Italy,41,0.05987036225852893,2.03723685438811,2,3,0
4,8,2,1,1,0.0,3,0,12,5,Italy,15,0.05861275449191914,-1.0152831048148063,3,0,2
7,8,1,0,1,0.0,0,0,15,1,France,706,0.4194671292710171,-0.5552771617958512,3,0,2
6,8,0,0,1,0.0,0,1,14,0,US,681,0.8876554294976162,-0.2861067139085986,1,3,0
4,8,0,0,1,0.0,0,0,12,0,France,676,1.3419139293825868,0.025257607180264242,1,3,0
8,9,3,7,14,100.0,0,0,17,3,France,27,-0.7881383474099223,1.1122327765362339,2,0,1
9,13,7,0,1,0.0,4,1,22,11,Spain,180,-0.7092779856482975,-1.6141294527512446,3,0,2
7,8,1,0,1,0.0,0,0,15,1,Netherlands,617,0.4194671292710171,-0.5552771617958512,3,0,2
6,8,3,0,1,0.0,1,0,14,4,Austria,273,0.11223076097302785,-1.121242978761253,3,0,2
11,15,2,0,2,50.0,0,0,26,2,Italy,201,-0.5478649397477409,0.37250655442577024,2,0,1
13,12,6,1,6,100.0,0,0,25,6,UK,14,-0.9889596128324647,1.06178782878191,2,0,1
14,37,4,4,8,87.0,0,0,51,4,UK,11,-1.1178290602902978,0.8951507604967585,0,0,1
8,8,312,1,5,60.0,123,18,16,435,Ireland,14,-1.3221220473549156,-0.7203459113940046,0,0,1
4,13,14,4,1,0.0,11,0,17,25,Germany,114,-0.5718052675171227,-1.0379502841665147,3,0,2
5,8,0,2,1,0.0,0,0,13,0,UK,42,0.9883603998147023,0.4497274122303112,1,3,0
4,8,0,0,1,0.0,0,0,12,0,France,285,1.3419139293825868,0.025257607180264242,1,3,0
63,8,2,7,49,86.4,0,0,71,2,Italy,12,-0.9539478316132686,1.3964753758643158,2,0,1
6,10,13,4,5,80.0,117,85,16,130,Finland,11,-1.4588526954318126,-0.7284628626804913,0,0,1
11,8,17,0,4,75.0,1,0,19,18,France,12,-0.6207693094158011,-0.050130422175478896,0,0,1
32,8,0,0,2,100.0,0,0,40,0,Germany,430,0.11722813304492494,1.8722548213209977,2,3,0
44,8,1,0,15,31.0,0,0,52,1,Italy,26,-0.5355131291052898,0.9063734582856602,2,0,1
5,8,0,0,1,0.0,0,0,13,0,France,632,1.2296015562652716,0.13122512192593444,1,3,0
4,8,0,1,2,0.0,0,0,12,0,Italy,633,0.8413762523236227,0.8615684580254663,1,3,0
8,8,1,2,12,75.0,0,0,16,1,Italy,19,-0.3719800875621872,0.8454016776659572,2,0,1
26,10,2,0,1,0.0,27,1,36,29,Italy,37,-0.8635364311428865,-1.4522537521964545,0,0,2
8,11,3,10,4,100.0,0,0,19,3,Sweden,13,-0.8708140481719122,1.0405129138483704,2,0,1
3,8,0,0,1,0.0,0,0,11,0,France,263,1.8211872325051162,-0.5087243978983337,1,3,3
103,431,7,13,66,93.0,0,0,534,7,Italy,15,-1.7201151758500919,1.3381926336917667,0,0,1
6,8,0,0,8,88.0,0,0,14,0,UK,189,0.6593178009003275,1.2258091718661932,2,3,0
4,8,0,0,3,100.0,0,0,12,0,France,458,0.735951246556057,1.3053603161256235,2,3,0
4,8,0,0,2,100.0,0,0,12,0,US,377,0.7515926006932446,1.2746420207833613,2,3,0
5,8,0,0,1,0.0,0,0,13,0,France,383,1.2296015562652716,0.13122512192593444,1,3,0
10,7,3,3,1,0.0,236,81,17,239,UK,11,-0.5712316763676182,-1.4313111939125231,3,0,2
7,8,0,2,4,75.0,0,0,15,0,Portugal,63,0.3853401228791965,1.5456406140911736,2,3,0
7,10,1,0,14,92.0,0,1,17,1,France,120,-0.6381048679897021,-0.026521198926661844,0,0,1
4,8,0,0,2,0.0,0,0,12,0,Italy,120,1.0692993892522236,0.5606494846910302,1,3,0
12,8,0,7,10,75.0,0,0,20,0,UK,11,0.16888171551009842,1.7893814618636037,2,3,0
28,8,87,0,1,0.0,0,3,36,87,Belgium,11,-0.41644237832726955,-0.9900607206632696,3,0,2
7,8,1,1,3,66.0,0,0,15,1,Spain,592,-0.26451653778896855,0.6888646613724748,2,0,1
28,8,0,0,1,0.0,4,1,36,4,France,142,-0.2308639591506347,-0.8404194282017804,3,0,2
6,10,6,0,1,0.0,0,0,16,6,France,640,0.11696587056401139,-0.738851635688587,3,0,2
32,11,0,17,3,66.0,0,0,43,0,Grèce,18,-0.2894934922441313,1.8429938148634564,2,3,0
5,8,0,4,2,0.0,0,0,13,0,France,11,0.6998064959614978,1.0061634760914255,1,3,0
10,8,0,5,4,50.0,1,1,18,1,Ireland,17,-0.6667353641127082,0.2985810731356035,0,0,1
5,8,0,1,1,0.0,0,0,13,0,UK,455,1.0016784193366708,0.43214409526037056,1,3,0
5,8,0,0,1,0.0,0,1,13,0,Ireland,679,0.9619647346242471,-0.3563773615782149,1,3,0
85,0,115,54,73,90.0,4,0,85,119,Spain,11,-0.8411806027679064,1.1570751657145342,2,2,2
11,10,153,27,13,92.0,63,6,21,216,Belgium,11,-1.7086307176063997,-0.4177481358740314,0,0,1
172,50,778,96,34,64.0,2,0,222,780,Italy,11,-2.1837012653769383,0.6019761152221494,0,0,1
9,8,7,1,1,0.0,0,1,17,7,Luxembourg,15,-0.2361796292401547,-0.7617446271745814,3,0,2
8,10,3,3,1,0.0,49,0,18,52,Austria,16,-0.6243858781557197,-0.9194273571210922,3,0,2
6,8,1,2,1,0.0,1,0,14,2,France,102,-0.09245394831902436,-0.7591073290895226,3,0,2
22,9,36,51,18,70.0,1,0,31,37,Italy,11,-1.3490502012698529,0.4873293050234117,0,0,1
5,8,0,0,1,0.0,0,0,13,0,UK,358,1.2296015562652716,0.13122512192593444,1,3,0
11,10,14,5,18,83.0,19,0,21,33,UK,12,-1.239690965229029,0.23735208175990327,0,0,1
7,8,0,1,3,100.0,0,0,15,0,France,379,0.261662822054314,1.8387356833848152,2,3,0
15,11,5,0,1,0.0,0,0,26,5,Belgium,586,-0.12558207967690496,-0.5270797318984775,3,0,2
12,11,6,1,8,100.0,5,0,23,11,Italy,12,-1.3075323194597002,0.564515933006785,0,0,1
6,9,2,0,1,0.0,1,0,15,3,Slovaquie,19,-0.08203547207475571,-1.1477095830624309,3,0,2
5,9,41,2,3,66.0,5,0,14,46,Italy,12,-0.8673216505037339,-0.13723880232431843,0,0,1
4,8,0,0,1,0.0,1,1,12,1,US,149,0.4128894830310619,-1.3369728085587682,3,0,2
3,8,0,1,2,100.0,0,0,11,0,France,138,1.0029427668871735,1.0415789890391995,2,3,3
8,10,16,1,1,0.0,0,0,18,16,France,30,-0.228143289635016,-0.4142133165130529,3,0,2
11,11,159,1,11,90.9,11,1,22,170,Italy,13,-1.5962841525734275,-0.43113228054213804,0,0,1
4,9,4,1,9,100.0,0,1,13,4,France,11,-0.7722646411208496,0.29184274003910116,0,0,1
6,8,1,0,1,0.0,0,0,14,1,Italy,460,0.4792107386002132,-0.6114953933053199,3,0,2
8,10,45,0,1,0.0,4,10,18,49,Germany,105,-0.7003847988166043,-1.8213009244362257,3,0,2
6,8,2,2,1,0.0,0,0,14,2,Italy,477,0.20932416198453005,-0.327401426360954,3,0,2
12,11,0,1,5,100.0,1,22,23,1,France,44,-1.1781473007870211,0.4718815957422338,0,0,1
3,8,5,5,1,0.0,0,0,11,5,France,21,0.8170049170371934,-1.0546484311450413,3,0,3
21,8,1,5,29,100.0,0,0,29,1,UK,198,-0.8016813521241536,1.478273887904317,2,0,1
3,8,0,0,1,0.0,0,0,11,0,France,694,1.8211872325051162,-0.5087243978983337,1,3,3
4,8,0,0,1,0.0,0,0,12,0,Italy,424,1.3419139293825868,0.025257607180264242,1,3,0
5,8,0,3,1,0.0,0,0,13,0,UK,427,0.9797504114900419,0.46109487971076213,1,3,0
3,8,0,0,2,0.0,0,2,11,0,Italy,15,1.2695584968941993,-0.48166322695868574,1,3,3
28,9,42,1,5,80.0,0,0,37,42,France,24,-0.9726362685966359,0.7928940760851416,0,0,1
4,8,0,0,1,0.0,0,0,12,0,UK,662,1.3419139293825868,0.025257607180264242,1,3,0
5,8,1,4,1,0.0,0,0,13,1,UK,15,0.29633952355343385,-0.34221956432021133,3,0,2
4,8,0,18,18,84.0,0,0,12,0,Italy,29,0.5299288628290767,1.4822782029984272,2,3,0
14,8,0,13,11,100.0,0,0,22,0,France,28,-0.03282837524776464,2.18059338046744,2,3,0
5,10,9,0,1,0.0,1,0,15,10,France,23,-0.1628006476268456,-1.2635537375515338,3,0,2
6,8,51,6,6,85.0,29,14,14,80,UK,14,-1.1426292295646714,-0.576622044201192,0,0,1
7,8,0,0,12,91.0,0,0,15,0,Italy,295,0.5822756237215072,1.316669330209746,2,3,0
15,8,1,3,11,100.0,0,0,23,1,Italy,12,-0.6890551436787905,1.3356160832073636,2,0,1
3,8,0,0,2,0.0,0,0,11,0,Italy,305,1.5485726923747536,0.02666747961243265,1,3,3
7,8,0,0,2,100.0,0,0,15,0,France,272,0.5052273131201024,1.5070984147081177,2,3,0
52,8,0,32,55,100.0,0,0,60,0,UK,86,-0.3949269371437804,2.5813215797242988,2,3,0
6,8,25,2,8,100.0,14,2,14,39,UK,27,-1.1860208753816803,-0.15126874452605224,0,0,1
6,8,0,0,3,100.0,0,0,14,0,France,332,0.5493295683121108,1.4815984785409104,2,3,0
7,8,0,0,1,0.0,0,0,15,0,France,29,1.0955486418094444,0.2577140011050198,1,3,0
89,61,10,1,14,91.6,0,0,150,10,Spain,11,-1.4187553016075531,1.0944077665062262,0,0,1
4,8,2,0,1,0.0,0,1,12,2,Italy,324,0.3695501750380213,-1.309744362584767,3,0,2
4,8,0,0,2,0.0,0,0,12,0,France,44,1.0692993892522236,0.5606494846910302,1,3,0
10,12,182,0,2,0.0,2,5,22,184,France,89,-1.1504996350628482,-1.2870650345066834,0,0,1
4,8,24,0,1,0.0,3,3,12,27,Sweden,30,-0.09004063843499002,-1.9456872900028075,3,0,2
7,12,42,0,1,0.0,2,1,19,44,Italy,15,-0.6950239041110845,-1.747226527568582,3,0,2
24,8,6,4,5,100.0,12,0,32,18,UK,22,-1.2273476571257291,0.7689986612547287,0,0,1
6,8,19,0,2,100.0,0,0,14,19,US,153,-0.23336095436653057,0.49095638966095534,2,0,1
4,8,0,0,1,0.0,0,0,12,0,US,650,1.3419139293825868,0.025257607180264242,1,3,0
6,8,0,0,1,0.0,0,0,14,0,UK,689,1.1552922511386405,0.2014957695955509,1,3,0
12,8,1,8,13,90.9,0,0,20,1,France,15,-0.5291265329618616,1.019756814438831,2,0,1
19,8,125,7,6,100.0,0,4,27,125,Germany,12,-1.252068066455458,0.5715447491313005,0,0,1
24,9,5,6,5,100.0,1,0,33,6,US,265,-1.3403680833327796,0.7986095754047865,0,0,1
5,8,3,0,1,0.0,23,2,13,26,Austria,524,-0.18585743325754506,-1.8246226912004835,3,0,2
8,9,1,1,1,0.0,1,17,17,2,Spain,13,-0.6937123342065894,-1.316897000255188,3,0,2
15,8,0,0,3,100.0,0,0,23,0,France,250,0.27862764908331655,1.736743756832103,2,3,0
36,8,3,21,21,90.0,0,0,44,3,Lettonie,12,-0.8584222954230891,1.2558295978316605,2,0,1
3,8,1,0,1,0.0,0,0,11,1,Germany,129,1.1451057199666888,-1.3217155607992037,3,0,3
5,8,0,0,3,100.0,0,0,13,0,France,58,0.6236388734387419,1.4113278308712944,2,3,0
3,8,0,0,1,0.0,0,0,11,0,France,398,1.8211872325051162,-0.5087243978983337,1,3,3
14,8,0,20,22,100.0,0,0,22,0,Italy,12,-0.06394785986399444,2.235555689049237,2,3,0
4,8,2,1,4,100.0,2,0,12,4,Italy,456,-0.5468334215966165,0.2982021863723978,2,0,1
4,8,4,1,4,50.0,1,0,12,5,UK,57,-0.4022413179332216,-0.05529906947657243,2,0,1
4,8,0,1,1,0.0,0,1,12,0,UK,23,0.8463539708129614,-0.1614259029894491,1,3,0
7,8,0,2,4,75.0,1,0,15,1,Netherlands,11,-0.2760475018313039,0.6710126818562896,2,0,1
96,0,3,0,50,96.0,214,32,96,217,Spain,13,-0.8686510983171115,0.10550498941291425,0,2,2
12,8,1,1,14,92.0,0,0,20,1,Germany,222,-0.48695741828465816,0.9664761466411662,2,0,1
13,8,2,3,1,0.0,0,0,21,2,Italy,17,-0.0388938876184825,-0.09026534081813152,3,0,2
4,8,208,1,1,0.0,31,11,12,239,Germany,11,-0.5044778725013079,-1.8931340828407248,3,0,2
38,30,61,2,3,100.0,11,0,68,72,Italy,15,-1.7959650705566774,0.5979101536683522,0,0,1
5,8,1,0,1,0.0,0,0,13,1,France,610,0.5535200437268443,-0.6817660409749363,3,0,2
5,0,4,4,2,100.0,1,2,5,5,UK,26,0.2582353328080973,-0.1787038527206725,2,1,2
14,8,0,6,9,55.0,0,2,22,0,France,33,-0.13337086018392647,1.2906741975040132,2,3,0
3,8,0,2,1,0.0,0,0,11,0,France,111,1.5799460760545474,-0.19022210759395686,1,3,3
4,8,41,0,1,0.0,0,2,12,41,France,162,0.22413135560336142,-1.4916407774137994,3,0,2
4,8,0,0,1,0.0,0,2,12,0,UK,582,1.062899733902033,-0.48307309939085413,1,3,0
4,8,1,0,2,0.0,0,0,12,1,France,203,0.39321787671379604,-0.252341678209841,3,0,2
3,8,0,0,1,0.0,0,0,11,0,France,331,1.8211872325051162,-0.5087243978983337,1,3,3
4,8,0,1,1,0.0,0,0,12,0,France,234,1.1139907924539858,0.3261765805147003,1,3,0
3,8,4,0,1,0.0,0,0,11,4,France,21,1.0880433111556682,-1.3902393007833027,3,0,3
9,8,0,1,2,0.0,175,3,17,175,Germany,11,-0.6387792201536745,-0.49576285090541783,0,0,1
23,8,5,0,1,0.0,7,0,31,12,France,61,-0.31101937456317513,-0.8642401565093684,3,0,2
4,8,0,0,4,75.0,0,0,12,0,France,47,0.8729465669029083,0.9946819298620404,1,3,0
15,9,2,0,3,0.0,0,1,24,2,UK,244,-0.5525190031352177,-0.3819486262141418,0,0,1
5,8,11,18,1,0.0,38,1,13,49,Romania,14,-0.5160712093896755,-1.4819259278672532,3,0,2
6,8,0,0,1,0.0,0,0,14,0,France,23,1.1552922511386405,0.2014957695955509,1,3,0
8,8,12,16,2,100.0,0,0,16,12,France,20,-0.6065093331167315,0.9957587550626459,2,0,1
5,8,0,4,8,87.0,0,0,13,0,France,51,0.4769965465170771,1.493849056820376,2,3,0
5,8,16,1,2,0.0,0,0,13,16,UK,517,-0.06230946632709815,0.016012242295941264,3,0,1
15,8,41,1,1,0.0,6,1,23,47,Grèce,73,-0.7959210959912327,-1.2291409198933951,3,0,2
5,8,0,2,1,0.0,0,0,13,0,France,630,0.9883603998147023,0.4497274122303112,1,3,0
13,29,320,3,1,0.0,24,8,42,344,Spain,11,-1.4585195481330118,-1.4996805327789366,0,0,2
7,8,0,0,2,100.0,0,0,15,0,UK,394,0.5052273131201024,1.5070984147081177,2,3,0
4,8,0,1,1,0.0,0,0,12,0,France,14,1.1139907924539858,0.3261765805147003,1,3,0
16,8,128,9,3,100.0,0,7,24,128,Grèce,11,-1.2140333380980353,0.483403254676251,0,0,1
21,2,61,11,11,100.0,225,1,23,286,France,24,-1.3332868336323052,0.20475387647434687,0,0,1
12,8,0,0,1,0.0,0,0,20,0,France,116,0.9363231343322683,0.40766584312921156,1,3,0
13,8,1,6,9,100.0,0,0,21,1,UK,11,-0.6670131781852153,1.3135081404004023,2,0,1
10,8,7,8,9,50.0,6,2,18,13,Croatie,309,-1.1644892449848416,-0.19598851267924597,0,0,1
3,8,1,1,1,0.0,0,0,11,1,France,36,0.9171825830380881,-1.0207965874647678,3,0,3
22,9,0,0,7,85.7,0,0,31,0,Italy,252,0.14080375954991362,1.4734526596147173,2,3,0
22,9,20,13,22,100.0,0,0,31,20,UK,14,-1.1234680461265953,1.2760240648297039,2,0,1
8,8,0,3,4,50.0,0,0,16,0,UK,23,0.33763014331893737,1.585099154663713,2,3,0
18,8,1,4,18,100.0,0,0,26,1,Sweden,22,-0.7502290788358095,1.4121985186447985,2,0,1
5,8,1,0,1,0.0,0,0,13,1,Spain,687,0.5535200437268443,-0.6817660409749363,3,0,2
31,13,9,1,5,66.0,0,0,44,9,Italy,484,-1.043194595338318,0.8586770956877922,0,0,1
4,8,0,0,2,0.0,0,0,12,0,France,294,1.0692993892522236,0.5606494846910302,1,3,0
5,8,0,0,6,100.0,0,0,13,0,France,199,0.6015439620739477,1.4547203662561428,2,3,0
13,8,3,0,1,0.0,1,0,21,4,UK,360,-0.1273773003053245,-0.8954743606988814,3,0,2
5,0,0,0,1,0.0,0,0,5,0,UK,343,2.438735218284601,0.07649590508851463,1,1,2
8,11,554,9,4,50.0,31,15,19,585,UK,11,-1.6706260237622754,-0.7333445907949983,0,0,1
8,14,10,0,1,0.0,2,6,22,12,France,42,-0.7363689265370553,-1.684118303062464,3,0,2
4,9,95,0,1,0.0,119,7,13,214,Netherlands,12,-0.5050494618976566,-2.186665975092788,3,0,2
5,8,0,0,3,100.0,0,0,13,0,France,647,0.6236388734387419,1.4113278308712944,2,3,0
13,8,0,0,4,100.0,0,0,21,0,France,430,0.29982631032397017,1.7268004252227263,2,3,0
5,13,15,0,1,0.0,6,1,18,21,Belgium,41,-0.6221157305688141,-1.788886247820237,3,0,2
3,10,30,1,2,0.0,14,10,13,44,Denmark,11,-0.6038350701429723,-1.6735081356348511,3,0,3
3,8,0,0,2,50.0,0,0,11,0,France,267,1.3844755140980816,0.3954482696445787,1,3,3
6,8,12,0,1,0.0,0,1,14,12,UK,16,0.10996799127287371,-1.2211776635708573,3,0,2
4,8,0,0,1,0.0,0,0,12,0,Belgium,533,1.3419139293825868,0.025257607180264242,1,3,0
9,8,36,0,3,66.0,3,1,17,39,Romania,34,-0.8755397045799814,-0.6858864460713467,0,0,1
16,8,1,11,3,66.6,0,0,24,1,US,442,-0.5447582862437644,0.9748504448849098,2,0,1
7,8,0,0,1,0.0,0,0,15,0,US,575,1.0955486418094444,0.2577140011050198,1,3,0
4,8,0,0,1,0.0,0,0,12,0,France,336,1.3419139293825868,0.025257607180264242,1,3,0
9,8,5,21,15,93.0,0,0,17,5,France,11,-0.545313606583794,0.9096944051399896,2,0,1
62,209,1533,12,7,100.0,11,0,271,1544,Italy,11,-2.340840097608083,0.6049619229633019,0,0,1
8,10,6,3,10,90.0,7,2,18,13,Italy,11,-1.3540600745943892,-0.3111145669480365,0,0,1
3,8,26,1,1,0.0,1,2,11,27,France,11,0.1830200475643374,-2.1447472333413105,3,0,3
14,25,41,0,2,100.0,457,38,39,498,Italy,11,-1.8272909550977807,-0.6687811328816258,0,0,1
4,8,0,1,3,100.0,0,0,12,0,France,217,0.508028109627456,1.6062792894600597,2,3,0
4,8,0,0,3,100.0,0,0,12,0,France,542,0.735951246556057,1.3053603161256235,2,3,0
7,8,0,0,5,0.0,0,0,15,0,Germany,21,0.7900532357262511,0.857681115682185,1,3,0
15,9,4,0,1,0.0,1,0,24,5,Swiss,471,-0.3458831956562986,-0.9488567707980299,3,0,2
3,8,8,1,1,0.0,8,0,11,16,UK,11,0.4687443363884678,-1.6355836749976462,3,0,3
4,8,0,0,1,0.0,0,0,12,0,Netherlands,584,1.3419139293825868,0.025257607180264242,1,3,0
10,9,0,0,1,0.0,0,0,19,0,France,46,0.8012776542156347,0.2980235545041719,1,3,0
5,8,0,0,1,0.0,0,0,13,0,France,671,1.2296015562652716,0.13122512192593444,1,3,0
6,9,0,0,1,0.0,0,4,15,0,Sweden,328,0.6554720875732128,-0.3728257366699058,1,3,0
11,9,76,3,10,80.0,8,1,20,84,Spain,194,-1.4593968384881577,-0.34949746143348415,0,0,1
38,9,0,5,28,96.0,0,0,47,0,Italy,14,-0.2941695485623459,2.0367745045587844,2,3,0
5,8,0,0,1,0.0,0,1,13,0,US,274,0.9619647346242471,-0.3563773615782149,1,3,0
5,0,2,0,1,0.0,0,0,5,2,Lettonie,447,1.73400828558106,-0.7709035811723673,3,1,2
44,9,71,0,20,85.0,1,4,53,72,Germany,348,-1.5233155759372023,-0.33405027766369666,0,0,1
5,8,2,0,1,0.0,0,0,13,2,France,635,0.5248746235617306,-0.7161743643349473,3,0,2
4,12,55,0,1,0.0,21,0,16,76,Denmark,83,-0.3495654976032988,-1.4813050419866352,3,0,2
7,11,399,0,2,100.0,4,74,18,403,China,38,-1.4660948793652961,-0.8222845179773061,0,0,1
5,9,0,0,1,0.0,0,0,14,0,France,17,1.0117480335209152,0.09572504937480913,1,3,0
3,8,6,0,1,0.0,0,3,11,6,UK,618,0.7858055402946409,-1.930836545652526,3,0,3
3,8,1,1,1,0.0,0,0,11,1,France,187,0.9171825830380881,-1.0207965874647678,3,0,3
4,8,23,0,3,100.0,1,0,12,24,Australia,17,-0.3899834537480228,-0.11687539990411895,2,0,1
11,8,150,1,2,100.0,5,33,19,155,France,11,-1.4417404106892326,-0.24837311967995562,0,0,1
4,8,0,1,2,0.0,0,0,12,0,UK,160,0.8413762523236227,0.8615684580254663,1,3,0
4,8,1,2,1,0.0,0,0,12,1,France,54,0.42459126039358985,-0.46923126541623,3,0,2
20,9,7,0,11,90.0,1,0,29,8,Italy,26,-0.9304829867989891,0.12643323340876172,0,0,1
11,8,2,0,10,72.7,3,1,19,5,UK,324,-0.8594713393328841,-0.4208140411165893,0,0,1
3,8,0,0,1,0.0,0,0,11,0,France,672,1.8211872325051162,-0.5087243978983337,1,3,3
3,8,11,0,1,0.0,14,0,11,25,UK,106,0.6674409778405331,-1.974383841259027,3,0,3
6,8,3,0,1,0.0,0,0,14,3,Sweden,680,0.4344189663566332,-0.6652937319871992,3,0,2
6,8,2,0,1,0.0,0,0,14,2,Germany,90,0.45056531843509934,-0.6459037166653305,3,0,2
6,8,0,1,2,100.0,0,0,14,0,France,66,0.33704778552069736,1.751799156533084,2,3,0
7,8,0,1,2,0.0,0,0,15,0,Italy,233,0.5950109647504805,1.0940248519502216,1,3,0
7,9,27,3,2,100.0,0,1,16,27,France,11,-1.0263935428649276,0.3166799876942065,0,0,1
3,8,0,2,1,0.0,1,0,11,1,Italy,544,0.9185584513440465,-1.06485003982884,3,0,3
4,8,0,1,2,100.0,0,0,12,0,UK,483,0.5236694637646436,1.5755609941177975,2,3,0
4,8,2,1,1,0.0,0,0,12,2,France,695,0.4092638597504447,-0.5212229057461812,3,0,2
3,8,0,0,1,0.0,0,0,11,0,Italy,605,1.8211872325051162,-0.5087243978983337,1,3,3
8,8,1,0,1,0.0,1,0,16,2,France,217,0.04322451434108221,-0.9782002836151821,3,0,2
3,8,0,0,1,0.0,0,0,11,0,France,632,1.8211872325051162,-0.5087243978983337,1,3,3
12,8,0,1,8,100.0,0,0,20,0,France,12,0.07206057315162237,2.048344873900723,2,3,0
5,8,0,0,1,0.0,0,0,13,0,Spain,658,1.2296015562652716,0.13122512192593444,1,3,0
4,8,0,2,2,50.0,0,0,12,0,UK,21,0.6639610545249823,1.2479325650275526,2,3,0
7,8,0,0,7,71.0,0,0,15,0,France,277,0.610944903764798,1.2574973016042144,2,3,0
4,8,21,0,1,0.0,6,2,12,27,Spain,53,-0.09066035141744418,-1.9445114902988037,3,0,2
12,12,5,0,1,0.0,2,16,24,7,Germany,11,-0.7622820323603376,-1.6188854871959513,3,0,2
7,8,0,0,1,0.0,0,0,15,0,Italy,351,1.0955486418094444,0.2577140011050198,1,3,0
6,8,0,0,1,0.0,0,0,14,0,France,346,1.1552922511386405,0.2014957695955509,1,3,0
9,8,3,2,9,88.0,0,0,17,3,Spain,206,-0.4470515915658673,0.8177093665815788,2,0,1
10,8,42,0,1,0.0,6,2,18,48,Finland,101,-0.4785801333374805,-1.648767146905529,3,0,2
3,8,1,0,1,0.0,0,0,11,1,Italy,305,1.1451057199666888,-1.3217155607992037,3,0,3
3,8,1,0,1,0.0,0,0,11,1,Italy,248,1.1451057199666888,-1.3217155607992037,3,0,3
8,8,0,2,9,88.0,0,0,16,0,Sweden,12,0.30841497480418206,1.651770839513067,2,3,0
4,8,1,2,1,0.0,0,0,12,1,UK,21,0.42459126039358985,-0.46923126541623,3,0,2
4,8,1,0,1,0.0,0,0,12,1,Belgium,704,0.6658324168441594,-0.7877335557206065,3,0,2
23,9,60,8,7,71.0,3,0,32,63,Italy,77,-1.3280360190117442,0.32749034507731684,0,0,1
4,8,0,0,1,0.0,0,0,12,0,France,179,1.3419139293825868,0.025257607180264242,1,3,0
6,8,1,0,2,50.0,13,2,14,14,France,31,-0.6480954056579935,-0.7896208712738367,0,0,1
3,8,16,3,1,0.0,2,17,11,18,Italy,34,0.1318505930316219,-2.1779168650006437,3,0,3
10,9,0,0,1,0.0,0,0,19,0,Italy,561,0.8012776542156347,0.2980235545041719,1,3,0
17,9,16,8,31,90.0,1,0,26,17,Spain,17,-1.2411580227775096,0.4855651018923063,0,0,1
19,9,11,22,11,81.0,8,0,28,19,Italy,16,-1.2731703628122144,0.42102300364401674,0,0,1
28,8,0,0,28,89.0,0,0,36,0,France,15,0.20876825440428487,1.6930077491855289,2,3,0
8,8,0,0,3,66.0,0,2,16,0,France,565,0.31465483173623887,0.7357972486370389,2,3,0
6,8,0,0,1,0.0,0,0,14,0,Germany,704,1.1552922511386405,0.2014957695955509,1,3,0
3,12,38,0,1,0.0,17,0,15,55,Lettonie,11,0.05106441245018601,-1.9094812838362185,3,0,3
6,10,0,4,3,0.0,23,1,16,23,France,20,-0.7261853469546685,-0.4496484065055677,0,0,1
5,8,3,0,2,0.0,0,0,13,3,Netherlands,421,0.23611373135290106,-0.20017250214604967,3,0,2
6,8,0,0,1,0.0,0,0,14,0,France,664,1.1552922511386405,0.2014957695955509,1,3,0
3,8,0,0,2,0.0,0,0,11,0,UK,57,1.5485726923747536,0.02666747961243265,1,3,3
7,8,0,2,7,85.0,0,0,15,0,Spain,22,0.3635778090104958,1.5897666072288035,2,3,0
6,9,0,0,2,50.0,0,0,15,0,France,684,0.5102080071822841,1.0623298921737552,2,3,0
7,9,2,0,6,66.0,3,0,16,5,Italy,162,-0.6362649229076571,-0.1488128307025658,0,0,1
5,8,0,0,1,0.0,0,1,13,0,Spain,659,0.9619647346242471,-0.3563773615782149,1,3,0
31,8,84,4,30,100.0,19,0,39,103,UK,14,-1.4683779837819135,0.8023200391046037,0,0,1
8,24,206,0,1,0.0,14,7,32,220,UK,75,-1.0655448592845402,-1.8799297891979005,0,0,2
3,9,0,4,3,100.0,0,0,12,0,France,20,0.6612949256479616,1.1406521193344994,2,3,3
6,8,18,11,1,0.0,5,0,14,23,Hong Kong,11,-0.269220092861503,-0.8757372204618101,3,0,2
4,8,0,1,1,0.0,0,0,12,0,France,83,1.1139907924539858,0.3261765805147003,1,3,0
10,8,6,3,1,0.0,0,0,18,6,Romania,271,-0.012436018113327812,-0.2108149248620865,3,0,2
5,8,0,4,3,100.0,0,0,13,0,France,112,0.36645835326533144,1.7508743075260198,2,3,0
10,8,7,0,4,100.0,0,0,18,7,France,614,-0.38485974512223076,0.751133375810399,2,0,1
22,8,0,2,44,89.1,0,0,30,0,France,11,0.014559259546809358,1.980370774550452,2,3,0
5,8,0,2,1,0.0,0,0,13,0,France,15,0.9883603998147023,0.4497274122303112,1,3,0
4,9,7,1,1,0.0,0,0,13,7,Italy,16,0.11319855554611671,-0.5955442236030326,3,0,2
5,8,8,6,3,100.0,12,4,13,20,France,11,-1.0725290911116967,-0.21491269352649228,0,0,1
14,9,1,1,1,0.0,0,0,23,1,Spain,14,-0.18083640146459967,-0.13935355502530955,3,0,2
4,8,3,6,4,100.0,18,1,12,21,UK,12,-0.9356759410222887,-0.2477790114252002,0,0,1
3,8,0,0,1,0.0,0,0,11,0,France,100,1.8211872325051162,-0.5087243978983337,1,3,3
14,8,1,5,11,100.0,0,0,22,1,Italy,11,-0.6861425652684567,1.3375433152105651,2,0,1
3,9,8,2,2,0.0,1,0,12,9,France,20,-0.06924253472193424,-0.9918973665151221,3,0,3
14,12,386,3,1,0.0,21,1,26,407,France,11,-1.2443852145421803,-1.4849961566040586,0,0,2
6,8,0,0,1,0.0,11,2,14,11,France,11,0.1290427559285053,-1.294373838903088,3,0,2
8,8,1,3,2,0.0,0,0,16,1,Croatie,422,-0.14881764009584253,0.35317557776898995,2,0,1
7,8,14,0,1,0.0,0,0,15,14,France,165,0.31112052551875075,-0.6854474287791296,3,0,2
5,8,0,0,1,0.0,0,0,13,0,US,611,1.2296015562652716,0.13122512192593444,1,3,0
4,8,0,0,1,0.0,0,1,12,0,Germany,173,1.0742771077415623,-0.4623448763238852,1,3,0
47,8,0,10,78,98.0,0,0,55,0,UK,13,-0.22083242349943663,2.243618183739162,2,3,0
5,10,12,6,1,0.0,3,4,15,15,France,15,-0.7518813019708992,-1.4845553601172992,3,0,2
3,8,0,1,1,0.0,0,0,11,0,France,11,1.593264095576516,-0.20780542456389742,1,3,3
4,8,0,0,1,0.0,0,0,12,0,France,574,1.3419139293825868,0.025257607180264242,1,3,0
48,8,0,19,3,0.0,0,0,56,0,Netherlands,545,0.04385891084012588,1.6553876029213632,2,3,0
4,8,0,0,1,0.0,0,0,12,0,France,408,1.3419139293825868,0.025257607180264242,1,3,0
5,8,3,1,6,83.0,0,0,13,3,Italy,11,-0.20375546770528535,0.566364499701363,2,0,1
17,9,49,0,9,77.0,21,12,26,70,Italy,12,-1.3436614097535642,-0.6863648288265158,0,0,1
3,8,0,0,1,0.0,0,0,11,0,France,709,1.8211872325051162,-0.5087243978983337,1,3,3
22,8,0,27,16,100.0,0,0,30,0,France,653,-0.15880904371690568,2.319746476026743,2,3,0
16,8,33,10,20,79.0,1,0,24,34,France,17,-1.0745153658041777,0.4678249898014236,0,0,1
3,8,0,0,3,100.0,0,0,11,0,France,286,1.2152245496785867,0.771378311047026,1,3,3
6,8,7,4,12,83.0,1,0,14,8,Italy,19,-0.6849798940563697,0.2262605537599772,0,0,1
5,8,1,1,3,66.0,0,0,13,1,Italy,386,-0.13046362333314143,0.5623757821933896,2,0,1
40,10,83,0,7,0.0,0,0,50,83,UK,604,-0.7390311734457055,0.12897220329404718,0,0,1
6,10,9,4,3,100.0,1,1,16,10,Italy,13,-1.348316539908941,-0.07741884693167414,0,0,1
5,8,0,0,1,0.0,0,0,13,0,France,638,1.2296015562652716,0.13122512192593444,1,3,0
5,8,0,0,1,0.0,0,0,13,0,Italy,665,1.2296015562652716,0.13122512192593444,1,3,0
8,8,0,7,8,100.0,0,0,16,0,France,28,0.14323332578384976,1.9973437790818254,2,3,0
4,8,1,0,1,0.0,0,0,12,1,France,595,0.6658324168441594,-0.7877335557206065,3,0,2
12,8,1,10,9,100.0,0,0,20,1,France,19,-0.6588817261650631,1.310422802202172,2,0,1
40,189,68,15,60,90.0,2,0,229,70,Lettonie,11,-2.004406085577778,0.6361637648450479,0,0,1
3,8,0,3,1,0.0,0,0,11,0,UK,114,1.571336087729887,-0.17885464011350596,1,3,3
40,122,28,18,17,66.0,3,2,162,31,Italy,13,-2.130540651489859,0.05633951830935612,0,0,1
3,8,2,5,1,0.0,3,0,11,5,UK,13,0.5035924651911252,-1.5039884751338142,3,0,3
8,10,70,2,6,100.0,49,8,18,119,Pologne,11,-1.6407831951494132,-0.271607507863079,0,0,1
4,8,3,0,3,100.0,0,0,12,3,France,14,0.01507796177404978,0.43857081454287405,2,0,1
16,2,91,5,5,80.0,10,1,18,101,Germany,11,-0.9807883555367252,-0.16594042966190012,0,0,1
11,23,334,0,1,0.0,84,2,34,418,France,11,-1.1318839248367838,-1.8662210527321061,0,0,2
4,8,0,1,1,0.0,0,0,12,0,France,618,1.1139907924539858,0.3261765805147003,1,3,0
25,12,30,1,8,87.0,4,28,37,34,France,62,-1.7257512057849402,-0.28511113347542383,0,0,1
6,12,112,0,1,0.0,65,9,18,177,France,11,-0.8165586314285153,-2.0115148447142,3,0,2
19,15,82,6,3,66.0,1,7,34,83,US,13,-1.7155575785719297,-0.3467466199706769,0,0,1
8,8,0,1,2,0.0,0,0,16,0,UK,175,0.5491918802892135,1.1372159562194692,2,3,0
3,8,3,0,1,0.0,0,0,11,3,France,132,1.1003139477231092,-1.375513899481083,3,0,3
6,8,1,0,5,100.0,0,0,14,1,US,25,-0.14399145604195956,0.7024642573641768,2,0,1
7,8,0,0,1,0.0,0,0,15,0,UK,700,1.0955486418094444,0.2577140011050198,1,3,0
11,9,34,11,13,92.0,9,1,20,43,France,14,-1.4729733210845548,-0.23036777382287382,0,0,1
8,10,54,0,1,0.0,4,3,18,58,Italy,44,-0.6851466098833116,-1.7888845488261673,3,0,2
4,8,0,0,2,100.0,0,0,12,0,US,91,0.7515926006932446,1.2746420207833613,2,3,0
15,8,57,55,9,77.0,6,10,23,63,UK,11,-1.437972841171036,-0.18042406823660165,0,0,1
3,11,21,0,1,0.0,0,0,14,21,Spain,11,0.5141612514741463,-1.372880423546684,3,0,3
47,94,494,0,4,60.0,56,6,141,550,US,35,-2.007938918425751,-0.718883707781684,0,0,1
5,8,13,7,7,87.0,0,0,13,13,Italy,11,-0.31329537105211436,0.5649246120141663,2,0,1
22,8,21,0,10,100.0,0,0,30,21,France,11,-0.6418465819672798,0.9187345950398105,2,0,1
8,8,1,0,1,0.0,0,0,16,1,UK,187,0.37364804480975017,-0.5120860575266034,3,0,2
34,147,39,0,6,50.0,49,23,181,88,Slovénie,12,-1.9423355675300096,-0.6019020697226576,0,0,1
17,8,6,17,19,100.0,1,0,25,7,Italy,12,-1.1655018606276732,0.9063707867601997,0,0,1
3,8,0,0,1,0.0,0,0,11,0,France,96,1.8211872325051162,-0.5087243978983337,1,3,3
7,10,19,5,2,100.0,109,3,17,128,UK,11,-1.552499511360821,-0.29786138302355275,0,0,1
11,8,5,2,11,100.0,0,0,19,5,Italy,15,-0.6710883697954276,1.1739306711643647,2,0,1
5,8,1,0,2,0.0,0,0,13,1,Italy,236,0.28090550359648103,-0.14637416346417056,3,0,2
5,8,2,0,1,0.0,0,0,13,2,France,25,0.5248746235617306,-0.7161743643349473,3,0,2
3,8,0,0,1,0.0,0,0,11,0,Australia,203,1.8211872325051162,-0.5087243978983337,1,3,3
6,8,1,1,3,100.0,0,0,14,1,Germany,18,-0.3546750811549175,0.969526288974476,2,0,1
6,8,0,0,1,0.0,0,0,14,0,Spain,191,1.1552922511386405,0.2014957695955509,1,3,0
5,8,0,0,1,0.0,0,0,13,0,France,673,1.2296015562652716,0.13122512192593444,1,3,0
6,8,0,0,1,0.0,0,0,14,0,Spain,670,1.1552922511386405,0.2014957695955509,1,3,0
4,8,0,0,1,0.0,0,1,12,0,France,254,1.0742771077415623,-0.4623448763238852,1,3,0
6,8,0,3,1,0.0,0,0,14,0,France,284,0.9054411063634108,0.5313655273803783,1,3,0
3,9,64,8,2,100.0,408,17,12,472,Germany,11,-0.9959225885616416,-1.150504676406936,0,0,3
19,8,3,2,12,91.0,0,0,27,3,Italy,11,-0.6395335716256179,1.0129977173687543,2,0,1
52,8,760,18,24,37.0,182,13,60,942,UK,12,-1.9325011616471963,-0.1977243406876602,0,0,1
8,8,0,1,4,50.0,0,0,16,0,Spain,626,0.35955815116556594,1.5561483702133216,2,3,0
9,22,23,0,1,0.0,6,5,31,29,UK,98,-0.9169945956778417,-1.6946232964168264,0,0,2
4,8,0,2,1,0.0,0,0,12,0,France,195,1.1006727729320174,0.343759897484641,1,3,0
12,8,0,4,19,94.0,0,0,20,0,France,164,0.1500848926835239,1.8376717435832821,2,3,0
3,8,0,0,1,0.0,0,0,11,0,Germany,657,1.8211872325051162,-0.5087243978983337,1,3,3
3,8,9,9,5,60.0,131,3,11,140,Germany,23,-0.4429084949815718,-1.2591176142416887,3,0,3
8,8,3,2,2,100.0,8,1,16,11,France,242,-1.1445642803703984,-0.011590909670892472,0,0,1
6,8,0,0,1,0.0,0,0,14,0,Sweden,672,1.1552922511386405,0.2014957695955509,1,3,0
4,8,9,1,4,25.0,1,0,12,10,France,157,-0.4301611881443755,-0.0954438075696642,2,0,1
10,8,5,48,26,95.0,3,1,18,8,Italy,11,-1.2188507589950361,0.021165264690399102,0,0,1
22,9,2,21,23,95.0,112,5,31,114,France,11,-1.683652042070903,-0.10486284744769434,0,0,1
6,8,0,0,2,0.0,0,0,14,0,UK,377,0.8826777110082771,0.7368876471063168,1,3,0
6,8,2,0,1,0.0,0,0,14,2,France,546,0.45056531843509934,-0.6459037166653305,3,0,2
4,9,4,8,2,0.0,0,0,13,4,Italy,11,-0.1823339044066432,0.027138601344902032,3,0,1
3,8,1,0,1,0.0,0,0,11,1,Denmark,12,1.1451057199666888,-1.3217155607992037,3,0,3
7,8,16,5,4,75.0,1,0,15,17,Italy,39,-0.744661439985593,0.17145926226322802,0,0,1
14,12,10,2,2,0.0,1,0,26,11,Italy,284,-0.9988390238483091,-0.17165858759238428,0,0,2
3,8,0,0,1,0.0,0,0,11,0,France,328,1.8211872325051162,-0.5087243978983337,1,3,3
9,10,2,1,6,66.0,1,0,19,3,France,13,-0.9739059198516838,0.24701044367557445,0,0,1
4,8,1,0,6,50.0,0,0,12,1,France,297,0.19138443293514307,0.19054994254941632,2,0,1
4,8,2,0,1,0.0,2,0,12,4,France,473,0.29694759486830224,-1.3022528245268417,3,0,2
7,8,0,0,7,85.0,0,0,15,0,Italy,319,0.6048189654610653,1.2712643169244273,2,3,0
6,8,0,23,2,0.0,0,0,14,0,Netherlands,11,0.5833344464920901,1.1321001255174372,2,3,0
4,8,0,0,1,0.0,0,0,12,0,France,617,1.3419139293825868,0.025257607180264242,1,3,0
6,8,1,0,1,0.0,0,0,14,1,France,372,0.4792107386002132,-0.6114953933053199,3,0,2
11,8,98,0,1,0.0,68,17,19,166,Australia,14,-0.642842225918055,-1.822632413874341,3,0,2
11,18,7,0,1,0.0,1,5,29,8,France,15,-0.8194562721264564,-1.5757223785289753,3,0,2
9,26,86,1,4,75.0,2,1,35,88,France,254,-1.6739120600193844,-0.40797561208111993,0,0,1
4,8,0,0,1,0.0,0,0,12,0,France,132,1.3419139293825868,0.025257607180264242,1,3,0
4,8,4,0,1,0.0,1,0,12,5,Ireland,146,0.28793008824938987,-1.3105423343156264,3,0,2
6,8,0,0,3,66.0,0,0,14,0,Ireland,334,0.6992317210072554,1.1447186194294412,2,3,0
3,8,0,0,1,0.0,0,0,11,0,France,378,1.8211872325051162,-0.5087243978983337,1,3,3
3,8,0,0,2,100.0,0,0,11,0,France,16,1.230865903815774,0.7406600157047636,1,3,3
3,8,0,4,1,0.0,0,0,11,0,France,68,1.5640067123317059,-0.16917792124360811,1,3,3
6,9,121,1,1,0.0,2,2,15,123,Luxembourg,33,-0.7828747291066072,-1.5901093201921905,3,0,2
6,8,1,0,2,0.0,0,0,14,1,France,379,0.2065961984698499,-0.07610351579455422,3,0,2
8,8,1,2,2,100.0,0,0,16,1,Italy,297,-0.4579144403301615,1.0558006463808702,2,0,1
4,8,0,0,3,0.0,0,0,12,0,Spain,330,1.0536580351150364,0.5913677800332927,1,3,0
3,8,0,0,1,0.0,0,0,11,0,France,376,1.8211872325051162,-0.5087243978983337,1,3,3
5,8,31,0,1,0.0,1,1,13,32,France,22,-0.17784417271498115,-1.7952911024449547,3,0,2
6,8,0,0,1,0.0,0,0,14,0,Netherlands,626,1.1552922511386405,0.2014957695955509,1,3,0
5,8,3,6,2,0.0,1,0,13,4,Italy,11,-0.352251929430622,-0.30469693227760863,3,0,1
9,8,1,1,2,66.0,0,0,17,1,France,31,-0.3292875497010904,0.7340654989507217,2,0,1
4,8,0,0,1,0.0,3,2,12,3,UK,646,0.36346559863169287,-1.407641171397966,3,0,2
4,8,0,0,1,0.0,0,0,12,0,France,44,1.3419139293825868,0.025257607180264242,1,3,0
8,8,0,0,1,0.0,0,0,16,0,Italy,45,1.0497295573481775,0.3009051053742676,1,3,0
13,8,0,0,4,50.0,0,0,21,0,Italy,624,0.45343592060627746,1.3815886791625405,2,3,0
11,8,19,2,2,0.0,26,0,19,45,Portugal,66,-0.7449407635427978,-0.27328620255811126,0,0,1
4,8,2,1,2,0.0,0,0,12,2,Netherlands,411,0.13664931962008162,0.014168971764584563,3,0,1
22,11,22,6,11,81.0,2,0,33,24,Italy,20,-1.3631354371701034,0.3889642433239404,0,0,1
4,8,0,0,1,0.0,0,0,12,0,France,700,1.3419139293825868,0.025257607180264242,1,3,0
5,8,0,0,1,0.0,0,0,13,0,UK,672,1.2296015562652716,0.13122512192593444,1,3,0
4,8,0,0,1,0.0,0,0,12,0,Italy,16,1.3419139293825868,0.025257607180264242,1,3,0
5,8,11,4,4,100.0,0,0,13,11,UK,34,-0.41694287793063917,0.8402665751321312,2,0,1
7,8,262,0,1,0.0,312,9,15,574,France,40,-0.5917409467483143,-2.051631239864464,3,0,2
5,5,34,0,3,66.0,5,5,10,39,France,16,-0.021601485723163436,-1.144324557542872,3,0,2
11,9,0,1,9,88.0,0,0,20,0,Spain,147,0.04946317504274425,1.653898908208829,2,3,0
4,9,0,0,2,0.0,0,0,13,0,France,683,0.8242630987750191,0.5476229316036946,1,3,0
6,8,0,0,1,0.0,0,0,14,0,France,184,1.1552922511386405,0.2014957695955509,1,3,0
22,9,8,1,20,80.0,10,0,31,18,France,11,-1.24915999510211,0.3976518349800746,0,0,1
4,8,1,0,1,0.0,0,0,12,1,France,275,0.6658324168441594,-0.7877335557206065,3,0,2
9,8,0,7,6,33.0,1,0,17,1,France,12,-0.3893047265535357,0.7904807753328932,2,0,1
4,8,0,0,2,0.0,0,0,12,0,France,139,1.0692993892522236,0.5606494846910302,1,3,0
6,8,0,0,1,0.0,0,0,14,0,France,395,1.1552922511386405,0.2014957695955509,1,3,0
7,8,688,0,1,0.0,2,2,15,690,France,11,-0.5085495661925025,-1.9145188984705535,3,0,2
26,8,0,0,2,0.0,0,0,34,0,US,626,0.4920845897876494,1.104793592567705,1,3,0
5,8,0,0,2,0.0,0,0,13,0,UK,220,0.9569870161349087,0.6666169994367005,1,3,0
4,9,0,1,1,0.0,1,0,13,1,France,446,0.20756687726628092,-0.5614779048075185,3,0,1
3,8,1,0,1,0.0,0,0,11,1,UK,639,1.1451057199666888,-1.3217155607992037,3,0,3
4,8,1,0,2,100.0,0,0,12,1,France,656,0.07551108815481715,0.4616508578824906,2,0,1
4,3,1,0,2,100.0,0,0,7,1,US,233,0.7325633976249036,0.30630733526042275,2,0,2
3,8,0,0,2,100.0,0,0,11,0,France,15,1.230865903815774,0.7406600157047636,1,3,3
9,8,0,5,10,100.0,0,0,17,0,France,26,0.10874441784168404,2.0349774594664916,2,3,0
4,8,0,1,1,0.0,0,0,12,0,France,651,1.1139907924539858,0.3261765805147003,1,3,0
3,8,5,0,1,0.0,0,0,11,5,Spain,11,1.0792216463891178,-1.4008440392390662,3,0,3
3,8,3,0,1,0.0,0,0,11,3,France,36,1.1003139477231092,-1.375513899481083,3,0,3
4,8,27,0,1,0.0,18,10,12,45,US,372,-0.16103453036953083,-2.0524483710665824,3,0,2
5,10,16,0,1,0.0,1,2,15,17,Germany,154,-0.46699949305599575,-1.8021689284783167,3,0,2
4,8,0,1,3,66.0,1,1,12,1,France,37,-0.2710941840289238,-0.09283098539044261,0,0,1
4,8,0,1,1,0.0,0,0,12,0,France,131,1.1139907924539858,0.3261765805147003,1,3,0
8,8,3,2,5,83.0,2,1,16,5,Swiss,16,-0.9965779648701797,-0.21943893966997766,0,0,1
6,8,1,0,2,100.0,2,2,14,3,Austria,60,-0.7385995124654889,-0.3607176110340902,0,0,1
67,30,345,4,42,79.0,157,12,97,502,Bulgaria,11,-2.28607060147667,-0.22947246450671838,0,0,1
44,90,105,4,19,94.0,7,1,134,112,Italy,11,-2.158184431006544,-0.03791946219653068,0,0,1
6,8,0,0,3,66.0,0,0,14,0,France,26,0.6992317210072554,1.1447186194294412,2,3,0
5,8,12,0,9,60.0,1,0,13,13,France,68,-0.3546987610368932,-0.24795790571378287,3,0,1
19,9,21,3,6,83.3,1,7,28,22,France,27,-1.496101829297396,-0.20496423102356431,0,0,1
16,9,0,4,12,91.0,12,279,25,12,France,11,-1.2023006018241442,0.1185782533844493,0,0,1
9,8,3,1,1,0.0,4,0,17,7,Denmark,54,-0.2882441924740918,-0.7320476539705748,3,0,2
3,8,2,1,1,0.0,0,3,11,2,France,13,0.602494424845349,-1.576340786656065,3,0,3
4,8,9,2,2,0.0,1,2,12,10,Germany,105,-0.5347973026937379,-1.0007691168376407,3,0,1
3,8,1,0,2,0.0,2,1,11,3,Denmark,25,0.25637963129949554,-1.7642020915533367,3,0,3
6,9,221,2,2,0.0,1,6,15,222,Spain,11,-1.115743750400937,-1.1042389581253347,0,0,1
13,10,3,2,1,0.0,0,0,23,3,Spain,11,-0.28236156668702744,-0.20425842128794175,3,0,2
9,8,2,4,2,50.0,18,1,17,20,Italy,16,-1.0644503186562122,-0.33501429165471464,0,0,1
7,8,0,0,2,100.0,0,0,15,0,France,25,0.5052273131201024,1.5070984147081177,2,3,0
3,8,0,0,1,0.0,0,0,11,0,Italy,665,1.8211872325051162,-0.5087243978983337,1,3,3
7,8,14,4,3,100.0,1,0,15,15,UK,17,-0.870252074778532,0.4831389233810903,0,0,1
6,8,9,0,2,0.0,9,0,14,18,UK,306,-0.24909045526041804,-0.7000841974074221,3,0,2
52,3,137,0,30,90.0,117,80,55,254,Luxembourg,11,-1.2881755852719117,-0.3533377431335003,0,0,1
5,8,0,0,1,0.0,0,0,13,0,France,649,1.2296015562652716,0.13122512192593444,1,3,0
11,9,3,0,1,0.0,0,0,20,3,France,568,0.05658645328276382,-0.5461730105427797,3,0,2
4,8,1,3,1,0.0,0,0,12,1,Italy,44,0.4159812720689299,-0.4578637979357793,3,0,2
4,8,0,0,1,0.0,0,0,12,0,US,251,1.3419139293825868,0.025257607180264242,1,3,0
3,9,5,0,1,0.0,0,0,12,5,France,319,0.7824725425319035,-1.371116707606319,3,0,3
3,8,2,0,2,100.0,11,1,11,13,UK,29,-0.13345514989558843,-1.1433561484272166,3,0,3
5,8,11,0,2,100.0,4,15,13,15,UK,88,-0.7945042922106551,-0.6120277730064335,0,0,1
4,9,43,1,2,100.0,0,2,13,43,Singapour,13,-0.8417518720343634,0.04253832271271913,0,0,1
3,8,0,1,1,0.0,0,0,11,0,France,588,1.593264095576516,-0.20780542456389742,1,3,3
5,9,1,0,1,0.0,2,0,14,3,UK,440,-0.012808205913318032,-1.2075420382868105,3,0,2
10,8,6,0,1,0.0,5,1,18,11,US,259,-0.38335092871651605,-1.5269116078617593,3,0,2
3,8,0,0,1,0.0,0,0,11,0,US,173,1.8211872325051162,-0.5087243978983337,1,3,3
10,11,85,1,8,25.0,104,1,21,189,Italy,23,-1.5695452101230989,-0.5426881707579594,0,0,1
15,10,1,0,1,0.0,0,0,25,1,US,634,-0.024309731537101104,-0.44215920969107975,3,0,2
8,10,42,0,1,0.0,17,2,18,59,US,54,-0.6995947279605963,-1.8077995239881386,3,0,2
7,15,0,0,1,0.0,14,0,22,14,US,30,-0.08760282693725135,-0.7660169088993345,3,0,2
28,11,2942,6,1,0.0,135,67,39,3077,Australia,11,-1.6183930777184163,-1.667932038467393,0,0,2
11,8,0,2,3,33.0,0,0,19,0,Spain,17,0.2677883756694568,1.6353582939553493,2,3,0
15,8,3,2,10,90.0,0,0,23,3,Italy,11,-0.582547056828567,0.9507814468334244,2,0,1
3,8,121,0,1,0.0,0,0,11,121,France,58,0.9260961581374978,-1.584864302808168,3,0,3
7,1,5,1,7,100.0,13,1,8,18,UK,24,-0.3238279021966639,-0.308844914952887,2,0,2
4,9,0,0,1,0.0,0,13,13,0,France,210,0.7837726481759484,-0.5582090301268345,1,3,0
4,8,0,1,3,100.0,0,0,12,0,France,46,0.508028109627456,1.6062792894600597,2,3,0
6,8,0,0,4,100.0,0,0,14,0,Swiss,354,0.5394343716023224,1.5010318071603543,2,3,0
16,8,30,5,24,84.0,71,1,24,101,UK,11,-1.4277888436735209,-0.15272285351968912,0,0,1
3,8,0,1,1,0.0,3,0,11,3,France,43,0.8938299603061755,-1.1323734965710088,3,0,3
10,8,0,2,4,100.0,0,0,18,0,Luxembourg,13,0.12965504485786453,1.9783299171451731,2,3,0
3,8,1,0,1,0.0,0,0,11,1,France,569,1.1451057199666888,-1.3217155607992037,3,0,3
12,12,196,0,3,100.0,69,58,24,265,US,12,-1.638239415046579,-0.6920267689891226,0,0,1
6,8,0,1,1,0.0,0,0,14,0,UK,209,0.9273691142100396,0.502414742929987,1,3,0
3,8,1,0,1,0.0,0,0,11,1,France,686,1.1451057199666888,-1.3217155607992037,3,0,3
25,8,0,1,1,0.0,0,0,33,0,Germany,170,0.546605334213987,0.8608333859973119,1,3,0
8,11,2,0,1,0.0,0,0,19,2,UK,693,0.039875131294618005,-0.6075711313675406,3,0,2
3,9,0,0,1,0.0,2,0,12,2,France,48,0.8388040420021288,-1.3854336018288251,3,0,3
26,8,1,2,2,100.0,0,0,34,1,France,28,-0.7429448677603264,1.324297256063542,2,0,1
5,8,0,2,4,75.0,0,0,13,0,Austria,45,0.5193930373350236,1.419151734912088,2,3,0
11,8,28,5,5,100.0,67,2,19,95,Portugal,30,-1.437502994340938,-0.02910149076329263,0,0,1
15,8,3,1,5,80.0,0,0,23,3,UK,11,-0.542618701270889,0.8793399507358016,2,0,1
4,8,0,7,2,100.0,0,0,12,0,Spain,11,0.4814357933809619,1.6313206370538442,2,3,0
7,8,164,0,1,0.0,30,10,15,194,Netherlands,18,-0.5061545018250092,-1.9400864813976237,3,0,2
8,8,162,0,1,0.0,4,4,16,166,Romania,11,-0.493463399958803,-1.8080045789735983,3,0,2
10,8,6,0,5,100.0,0,0,18,6,Italy,17,-0.38578706798027096,0.7732749680225828,2,0,1
5,8,1,0,2,0.0,0,0,13,1,Germany,257,0.28090550359648103,-0.14637416346417056,3,0,2
9,8,0,2,10,83.0,0,0,17,0,UK,32,0.2732169826744139,1.6847988033703771,2,3,0
3,8,0,4,4,75.0,0,0,11,0,France,11,1.0950393498520277,0.8002464014381678,1,3,3
14,8,0,3,27,100.0,0,0,22,0,UK,62,-0.026073280889718636,2.1899402495760305,2,3,0
3,8,0,0,1,0.0,0,0,11,0,Italy,709,1.8211872325051162,-0.5087243978983337,1,3,3
3,8,28,1,2,100.0,1,1,11,29,Spain,11,-0.39915340261466564,-0.8785050308571526,3,0,3
4,8,0,3,1,0.0,0,1,12,0,France,125,0.824425962966333,-0.132475118539058,1,3,0
5,8,0,1,5,100.0,0,0,13,0,Italy,137,0.378476224694498,1.7461037459298674,2,3,0
13,8,2,10,1,0.0,0,0,21,2,Estonie,11,-0.06772769069499901,-0.05219707562998307,3,0,2
7,8,0,2,1,0.0,0,0,15,0,Grèce,30,0.854307485358875,0.5762162914093966,1,3,0
4,8,0,0,1,0.0,0,0,12,0,France,40,1.3419139293825868,0.025257607180264242,1,3,0
9,8,5,10,12,100.0,1,1,17,6,UK,11,-1.2444289985765675,0.23769735278391724,0,0,1
28,8,4,0,47,77.0,8,1,36,12,UK,21,-1.170950862871624,-0.1828773262517013,0,0,1
3,8,0,0,1,0.0,0,0,11,0,France,685,1.8211872325051162,-0.5087243978983337,1,3,3
20,8,11,12,30,93.0,0,1,28,11,Italy,12,-1.0421284576628802,0.5869444611270525,0,0,1
4,8,0,2,2,100.0,0,0,12,0,France,119,0.5103514442426749,1.5931443110877381,2,3,0
11,9,20,1,8,62.0,1,1,20,21,Bulgaria,49,-1.3223013286611434,-0.2805405993716093,0,0,1
6,12,52,2,1,0.0,446,8,18,498,Italy,11,-1.107107832539212,-1.7616080041751283,0,0,2
6,8,1,0,2,100.0,0,0,14,1,Italy,225,-0.11111059008912916,0.6378890202977773,2,0,1
6,8,69,6,2,100.0,8,4,14,77,Singapour,11,-1.2078721868044044,-0.2651047133218654,0,0,1
5,9,1,3,1,0.0,1,0,14,2,Italy,181,-0.24460815426140955,-0.8535105818298134,3,0,2
4,8,2,0,1,0.0,5,5,12,7,UK,11,-0.02459128581007355,-1.8756820913591108,3,0,2
13,8,40,14,8,62.0,0,0,21,40,Italy,198,-0.6933423636075977,0.7986340587306949,2,0,1
8,8,50,2,9,100.0,1,0,16,51,Italy,11,-0.996481002745021,0.4985794405057705,0,0,1
3,8,1,0,1,0.0,0,0,11,1,France,226,1.1451057199666888,-1.3217155607992037,3,0,3
3,8,0,0,1,0.0,0,0,11,0,UK,655,1.8211872325051162,-0.5087243978983337,1,3,3
6,10,9,1,1,0.0,2,0,16,11,UK,39,-0.4581850837271966,-0.9261346067264874,3,0,2
6,8,0,0,1,0.0,0,0,14,0,France,533,1.1552922511386405,0.2014957695955509,1,3,0
3,8,0,0,1,0.0,0,0,11,0,France,701,1.8211872325051162,-0.5087243978983337,1,3,3
31,27,161,4,24,100.0,612,20,58,773,Bulgaria,11,-2.3344430713461914,-0.09932804736356965,0,0,1
9,9,15,11,8,85.7,3,0,18,18,France,100,-1.071869757410764,0.24067738729255944,0,0,1
18,16,52,0,18,100.0,4,48,34,56,Spain,12,-1.6974821829542674,-0.32673298982836346,0,0,1
12,8,0,6,6,33.0,0,0,20,0,UK,11,0.19724910864146294,1.7338876170434718,2,3,0
7,8,2,0,1,0.0,0,0,15,2,Croatie,500,0.3908217091059035,-0.5896854851558619,3,0,2
12,8,5,0,1,0.0,0,0,20,5,France,44,0.19435754821627002,-0.48445379821152196,3,0,2
34,8,6,7,11,83.0,0,0,42,6,Croatie,12,-0.8260315115314149,1.1274485016566262,2,0,1
4,8,1,1,3,33.0,0,0,12,1,France,84,-0.012892379010535073,0.44458983950074515,2,0,1
19,9,13,35,23,82.0,1,0,28,14,France,11,-1.2709470441486719,0.5302351073399897,0,0,1
4,9,0,1,2,66.0,0,0,13,0,France,11,0.4285353259825841,1.2256545819189926,2,3,0
15,8,0,10,38,84.0,1,0,23,1,France,11,-0.599899645392322,1.0687633247951387,2,0,1
131,10,14,122,152,92.0,7,0,141,21,US,12,-1.8389238380005553,1.0072208418650948,0,0,1
13,9,1,0,1,0.0,1,1,22,2,Estonie,516,-0.5353539276245227,-1.4088052307638406,3,0,2
4,8,0,0,1,0.0,0,0,12,0,France,573,1.3419139293825868,0.025257607180264242,1,3,0
9,9,3,1,2,100.0,0,0,18,3,US,256,-0.7101786519500614,0.9554748696419842,2,0,1
4,8,1,0,1,0.0,0,0,12,1,France,367,0.6658324168441594,-0.7877335557206065,3,0,2
5,8,1,10,11,90.0,0,0,13,1,Spain,71,-0.23372554133919143,0.7355473153128221,2,0,1
121,0,1140,31,108,94.0,531,105,121,1671,Sweden,11,-1.512451266907816,0.2612447531880768,0,2,2
7,13,357,3,3,100.0,6,24,20,363,France,11,-1.7753795497613927,-0.4036045645537974,0,0,1
6,8,3,1,1,0.0,47,13,14,50,France,13,-0.5498240993142512,-1.5515547182763962,3,0,2
4,8,4,0,1,0.0,3,0,12,7,France,12,0.26484712599710203,-1.3420127528021657,3,0,2
13,8,11,9,10,70.0,0,0,21,11,Italy,18,-0.6300490909034557,0.8839629562735007,2,0,1
7,8,1,16,2,100.0,0,0,15,1,US,12,-0.4590843229691495,1.0746474375547863,2,0,1
6,12,16,3,1,0.0,214,8,18,230,US,11,-1.0489719500824866,-1.666723242040208,0,0,2
12,8,0,3,10,90.0,0,0,20,0,UK,13,0.1814490420512023,1.7799632111390933,2,3,0
15,15,22,1,2,0.0,2,4,30,24,UK,424,-1.3851228339234836,-0.7634262425630858,0,0,1
5,8,0,0,2,0.0,0,0,13,0,France,187,0.9569870161349087,0.6666169994367005,1,3,0
5,8,0,0,1,0.0,0,0,13,0,Spain,625,1.2296015562652716,0.13122512192593444,1,3,0
8,8,0,0,1,0.0,0,3,16,0,US,31,0.7636868193205522,-0.22023077045701864,1,3,0
11,8,6,19,2,100.0,1,2,19,7,US,371,-1.271215528571431,0.15908706773069858,0,0,1
6,8,0,2,1,0.0,0,0,14,0,US,94,0.914051094688071,0.5199980598999275,1,3,0
10,8,0,4,1,0.0,0,0,18,0,Italy,621,0.7295735606713416,0.699838065930718,1,3,0
6,8,15,2,1,0.0,15,1,14,30,Islande,11,-0.5205210876569184,-1.4493747679199194,3,0,2
5,9,32,2,2,100.0,2,5,14,34,Germany,424,-1.2689993689182948,-0.3329256262504958,0,0,1
14,10,41,1,2,100.0,0,0,24,41,Italy,469,-0.9926690979307353,0.9004064095671255,2,0,1
14,12,10,2,2,100.0,0,0,26,10,Italy,26,-0.9976433123432739,0.9942276022934833,2,0,1
11,8,48,2,4,100.0,4,11,19,52,Netherlands,14,-1.3932203286557885,-0.06064094309441573,0,0,1
5,8,0,2,2,0.0,0,0,13,0,France,15,0.7157458596843388,0.9851192897410775,1,3,0
8,8,6,1,5,100.0,0,0,16,6,Netherlands,13,-0.550734728405446,1.0148074574552937,2,0,1
4,8,0,1,1,0.0,0,1,12,0,France,348,0.8463539708129614,-0.1614259029894491,1,3,0
7,9,141,2,5,100.0,171,9,16,312,Austria,11,-1.6046279467105766,-0.4077388509627093,0,0,1
24,8,0,27,13,69.0,0,0,32,0,France,11,-0.027290837249531887,1.995311079434092,2,3,0
5,9,0,8,3,100.0,0,0,14,0,Spain,32,0.13233226886217164,1.736858330946346,2,3,0
7,8,38,3,4,0.0,14,0,15,52,France,40,-0.6542371440145883,-0.3499333495137807,0,0,1
3,8,0,0,1,0.0,0,0,11,0,Netherlands,68,1.8211872325051162,-0.5087243978983337,1,3,3
5,8,86,0,1,0.0,4,2,13,90,UK,14,-0.2652388244818169,-1.9118970888860611,3,0,2
6,8,0,1,1,0.0,0,0,14,0,US,251,0.9273691142100396,0.502414742929987,1,3,0
5,8,3,0,1,0.0,0,1,13,3,US,561,0.24109144984223999,-1.2231668631609653,3,0,2
8,12,30,1,2,0.0,2,0,20,32,UK,13,-0.9393633098123899,-0.37108581788233536,0,0,2
4,8,0,0,1,0.0,0,0,12,0,France,590,1.3419139293825868,0.025257607180264242,1,3,0
4,8,3,0,1,0.0,0,0,12,3,France,400,0.6210406446005794,-0.8415318944024855,3,0,2
12,9,14,13,7,85.0,0,0,21,14,Italy,15,-0.80393739735309,0.7876116608842001,2,0,1
19,12,4,12,13,92.3,2,1,31,6,France,12,-1.5878501802758693,0.002396348666674503,0,0,1
6,8,0,0,1,0.0,0,0,14,0,Estonie,384,1.1552922511386405,0.2014957695955509,1,3,0
23,8,1,15,22,95.0,0,0,31,1,Spain,12,-0.7019162944774182,1.2063405080866776,2,0,1
9,8,0,1,1,0.0,0,0,17,0,France,325,0.7872131388315343,0.6345521073599655,1,3,0
6,8,0,0,3,66.0,0,0,14,0,France,274,0.6992317210072554,1.1447186194294412,2,3,0
5,9,109,3,1,0.0,8,8,14,117,Germany,14,-0.781310706048078,-1.6938464238419182,3,0,2
10,24,342,7,3,66.0,425,10,34,767,Italy,11,-1.9415396814376085,-0.7079921571585348,0,0,1
8,8,0,0,1,0.0,0,0,16,0,Italy,688,1.0497295573481775,0.3009051053742676,1,3,0
4,8,4,1,1,0.0,0,0,12,4,Germany,44,0.3808468711045375,-0.5553383223702694,3,0,2
4,9,0,0,2,0.0,0,0,13,0,France,647,0.8242630987750191,0.5476229316036946,1,3,0
6,9,2,3,1,0.0,2,1,15,4,Netherlands,19,-0.6155345753412195,-1.3270859327955848,3,0,2
3,8,59,0,1,0.0,29,0,11,88,UK,12,0.5833956798629203,-2.0777221695683634,3,0,3
7,8,0,2,9,90.0,0,0,15,0,UK,94,0.35302126631240693,1.611305283288371,2,3,0
4,8,4,8,2,50.0,4,0,12,8,UK,35,-0.45334581089042664,-0.08761433143399801,0,0,1
9,8,0,0,3,100.0,0,0,17,0,US,610,0.40917359293360567,1.6137358429708888,2,3,0
4,8,0,0,1,0.0,0,0,12,0,US,44,1.3419139293825868,0.025257607180264242,1,3,0
15,8,9,14,27,74.0,0,0,23,9,Slovaquie,15,-0.6963403023640679,0.9999421887332269,2,0,1
4,8,1,0,1,0.0,1,0,12,2,France,16,0.3354088863754914,-1.2538477818091855,3,0,2
19,8,0,1,19,50.0,0,0,27,0,Belgium,462,0.09625743236110071,1.8546394766335397,2,3,0
4,8,0,0,1,0.0,0,2,12,0,France,11,1.062899733902033,-0.48307309939085413,1,3,0
4,8,0,0,1,0.0,0,0,12,0,Belgium,205,1.3419139293825868,0.025257607180264242,1,3,0
22,14,185,0,5,100.0,37,53,36,222,Luxembourg,12,-1.7861687359476168,-0.5241766747542028,0,0,1
3,8,0,0,1,0.0,0,0,11,0,France,519,1.8211872325051162,-0.5087243978983337,1,3,3
60,9,41,244,70,88.0,37,14,69,78,France,11,-2.1384888973373557,0.2806571452380745,0,0,1
4,8,3,4,4,80.0,0,0,12,3,Germany,61,-0.10720817193710322,0.4721604002449191,2,0,1
4,8,0,2,1,0.0,0,0,12,0,France,406,1.1006727729320174,0.343759897484641,1,3,0
10,8,0,0,3,100.0,0,0,18,0,France,13,0.38079139801822215,1.6403942982213513,2,3,0
14,8,0,0,1,0.0,0,0,22,0,France,691,0.8998684948968748,0.44224242958074617,1,3,0
13,8,0,1,6,100.0,0,0,21,0,Italy,11,0.059703458740363514,2.051678605322566,2,3,0
6,8,11,0,3,66.0,1,0,14,12,France,48,-0.39282464805363954,-0.236781412486702,3,0,1
3,8,0,0,1,0.0,0,0,11,0,Germany,385,1.8211872325051162,-0.5087243978983337,1,3,3
6,8,4,5,7,85.0,0,0,14,4,France,14,-0.3307980759111117,0.6797267906240143,2,0,1
5,15,420,0,1,0.0,5,0,20,425,France,11,-0.5730812388691743,-1.48013285306538,3,0,2
4,8,0,0,1,0.0,0,0,12,0,France,68,1.3419139293825868,0.025257607180264242,1,3,0
9,17,3,3,8,100.0,0,0,26,3,Italy,12,-1.0125768233996104,1.0928740239535442,2,0,1
5,5,15,1,1,0.0,0,5,10,15,Romania,40,0.592222876082659,-1.2490653222753505,3,0,2
42,8,0,5,29,86.0,0,0,50,0,UK,15,-0.13987733388761076,2.1210662630123913,2,3,0
5,8,0,2,1,0.0,0,0,13,0,France,691,0.9883603998147023,0.4497274122303112,1,3,0
7,8,0,2,2,0.0,46,0,15,46,France,595,-0.22556386802193115,0.045616586110512926,3,0,1
14,12,19,1,3,100.0,9,0,26,28,France,219,-1.3890734228414459,0.4634660383920662,0,0,1
7,8,4,6,8,100.0,0,0,15,4,Italy,13,-0.5401121591919666,1.0673839722996206,2,0,1
21,9,0,0,13,100.0,9,3,30,9,Germany,390,-1.0358952508761574,0.324672953415626,0,0,1
3,8,19,0,1,0.0,0,0,11,19,Italy,52,1.0228553556892874,-1.4686481914360257,3,0,3
30,60,1209,0,3,100.0,919,9,90,2128,Singapour,11,-2.1978476146754238,-0.6680455513073292,0,0,1
3,8,1,0,1,0.0,0,0,11,1,France,701,1.1451057199666888,-1.3217155607992037,3,0,3
4,8,0,0,1,0.0,0,0,12,0,France,259,1.3419139293825868,0.025257607180264242,1,3,0
4,8,3,0,1,0.0,0,1,12,3,Germany,324,0.3534038229595551,-1.3291343779066351,3,0,2
7,8,0,1,1,0.0,0,0,15,0,Spain,641,0.8676255048808437,0.5586329744394557,1,3,0
6,8,21,3,1,0.0,5,0,14,26,Germany,165,-0.24456082633598966,-0.9252009239791827,3,0,2
15,10,136,9,4,50.0,13,5,25,149,UK,22,-1.6449501951225665,-0.4442330416811926,0,0,1
12,9,0,0,5,60.0,0,0,21,0,UK,426,0.2848105937848774,1.3137642180501754,2,3,0
7,8,2,11,13,84.0,0,0,15,2,Italy,11,-0.4020269417126011,0.8360157384418583,2,0,1
59,108,1,2,7,71.0,0,0,167,1,Italy,11,-1.3284189912334048,1.1329955805569478,0,0,1
10,8,226,1,3,100.0,185,25,18,411,France,11,-1.5283851760200509,-0.37070174004792017,0,0,1
5,8,2,1,4,75.0,0,0,13,2,Spain,29,-0.1720158758465489,0.5541689316812655,2,0,1
4,8,0,0,1,0.0,0,0,12,0,France,617,1.3419139293825868,0.025257607180264242,1,3,0
14,10,25,1,2,0.0,47,1,24,72,Lituanie,471,-1.3212340115351309,-0.839051436276233,0,0,1
8,11,40,0,1,0.0,58,3,19,98,France,53,-0.7819264929653831,-1.856003348449989,3,0,2
5,8,0,0,2,50.0,29,0,13,29,Italy,280,0.0041066568135062044,-0.006716574530173557,2,0,1
10,8,0,1,4,75.0,0,0,18,0,Italy,204,0.28986358143647245,1.6306348852922041,2,3,0
6,8,0,0,1,0.0,0,0,14,0,France,41,1.1552922511386405,0.2014957695955509,1,3,0
12,8,1,0,11,75.0,0,0,20,1,Italy,194,-0.24058067942449937,0.626659405781978,2,0,1
15,8,1,17,26,88.0,0,0,23,1,Spain,20,-0.615230312452932,1.125182649061137,2,0,1
6,10,0,0,1,0.0,0,0,16,0,France,687,0.8663048247468617,0.16212463623431927,1,3,0
4,8,1,0,3,0.0,0,0,12,1,Canada,17,0.3775765225766088,-0.22162338286757843,3,0,2
4,8,4,0,1,0.0,0,1,12,4,Germany,525,0.34113318639211393,-1.3438597792088547,3,0,2
6,8,0,0,1,0.0,0,1,14,0,Italy,57,0.8876554294976162,-0.2861067139085986,1,3,0
12,8,3,15,19,94.0,0,0,20,3,Italy,11,-0.6010420849400234,1.0108251381546138,2,0,1
7,8,0,0,1,0.0,0,0,15,0,Italy,673,1.0955486418094444,0.2577140011050198,1,3,0
8,9,1,2,4,100.0,0,0,17,1,France,18,-0.6734953628044762,1.04746081203405,2,0,1
8,8,0,0,1,0.0,0,1,16,0,Spain,442,0.7820927357071534,-0.18669737812988194,1,3,0
5,8,9,0,1,0.0,0,0,13,9,France,231,0.46367640414817424,-0.7896888287292269,3,0,2
6,8,0,0,2,0.0,0,0,14,0,France,397,0.8826777110082771,0.7368876471063168,1,3,0
10,9,2,1,7,100.0,24,4,19,26,France,12,-1.4797148352446223,-0.0382501449866051,0,0,1
20,8,106,1,4,75.0,0,2,28,106,Germany,44,-1.0376152517732575,0.2057176581224861,0,0,1
8,8,25,0,1,0.0,4,3,16,29,Croatie,29,-0.3892774338288764,-1.6795920490827665,3,0,2
30,37,27,1,5,100.0,3,2,67,30,Spain,218,-2.0081262130432225,0.16204782183305785,0,0,1
12,8,15,1,1,0.0,69,2,20,84,France,224,-0.7871178345665435,-1.3469996422181525,3,0,2
6,8,0,0,3,100.0,0,0,14,0,US,183,0.5493295683121108,1.4815984785409104,2,3,0
10,18,5,0,1,0.0,3,2,28,8,Germany,38,-0.7974918102170153,-1.5742548426037235,3,0,2
10,16,2,1,2,100.0,1,0,26,3,Germany,28,-1.2532489008680359,0.5479084091493852,0,0,1
3,8,117,1,1,0.0,2,0,11,119,Italy,12,0.3735430506424144,-1.7448811561301065,3,0,3
15,9,3,11,12,91.0,5,0,24,8,Italy,20,-1.1683289949368225,0.44198265224101024,0,0,1
4,8,1,0,1,0.0,10,1,12,11,US,392,-0.0019096722589878059,-1.8340146820056111,3,0,2
8,9,2,14,11,100.0,0,0,17,2,Italy,11,-0.7794661484457143,1.1356459110774024,2,0,1
8,8,0,0,5,80.0,0,0,16,0,France,212,0.5713169458780506,1.2894745364716407,2,3,0
23,8,165,4,21,80.0,0,1,31,165,France,13,-1.1682676179482985,0.37013112445894325,0,0,1
4,8,0,0,2,100.0,1,0,12,1,Netherlands,631,0.090204975982744,0.4000140885484781,2,0,1
22,20,20,5,6,100.0,0,0,42,20,US,12,-1.2773805202637818,1.1527208872407015,0,0,1
5,8,3,10,7,100.0,0,0,13,3,Italy,14,-0.40268424078194615,0.9650403138071145,2,0,1
24,23,34,46,34,85.0,9,1,47,43,Italy,11,-1.9312585701678098,0.0012332047613298704,0,0,1
3,8,0,0,1,0.0,0,0,11,0,France,313,1.8211872325051162,-0.5087243978983337,1,3,3
4,10,126,4,2,100.0,32,2,14,158,Italy,11,-1.409063124007097,-0.506112229011943,0,0,1
7,8,0,9,4,66.6,0,0,15,0,Italy,12,0.35194209920903236,1.5881589877053057,2,3,0
12,7,30,1,1,0.0,0,1,19,30,Italy,34,-0.09622021953225472,-0.6533917321975412,3,0,2
4,8,1,0,1,0.0,1,0,12,2,UK,200,0.3354088863754914,-1.2538477818091855,3,0,2
3,8,1,0,1,0.0,1,0,11,2,UK,293,0.8146821894980207,-1.7878297868877828,3,0,3
4,9,16,0,1,0.0,15,1,13,31,France,37,-0.34017985845840737,-1.9600963134137912,3,0,2
3,0,0,0,1,0.0,0,0,3,0,France,44,3.2755774739096934,-0.7662209916491926,1,1,2
4,8,4,0,1,0.0,0,0,12,4,Portugal,14,0.6087700080331384,-0.8562572957047054,3,0,2
3,8,0,0,1,0.0,0,0,11,0,Italy,664,1.8211872325051162,-0.5087243978983337,1,3,3
18,9,19,84,29,66.0,15,0,27,34,Italy,11,-1.3598143658756225,0.44919336680098165,0,0,1
4,8,0,0,2,100.0,0,0,12,0,France,376,0.7515926006932446,1.2746420207833613,2,3,0
13,8,1,4,4,75.0,0,0,21,1,UK,14,-0.4865452053312282,0.9232440240935534,2,0,1
12,5,1,4,6,33.0,12,1,17,13,France,11,-0.810431543578459,-0.06305401893966117,0,0,1
3,9,2,0,1,0.0,0,1,12,2,UK,11,0.5520743743033363,-1.8139990360306166,3,0,3
4,8,7,0,1,0.0,0,0,12,7,UK,442,0.586157982951922,-0.8834366438501331,3,0,2
5,7,4,7,7,100.0,2,1,12,6,France,50,-0.6619208413875663,0.039383469783480646,0,0,2
7,8,1,7,7,71.0,0,0,15,1,France,20,-0.33529341608591196,0.8011847549738258,2,0,1
8,8,6,0,1,0.0,4,2,16,10,Australia,68,-0.3259286823353681,-1.5992276129457557,3,0,2
130,12,1,47,123,91.0,0,0,142,1,Germany,11,-1.3778143092097443,1.5562157964561658,0,0,1
3,2,32,0,1,0.0,11,0,5,43,France,25,1.2169272490933238,-2.090895032014125,3,0,3
8,8,36,3,2,0.0,0,0,16,36,France,475,-0.304197481132236,0.16640709057448094,2,0,1
5,8,0,0,1,0.0,0,0,13,0,UK,418,1.2296015562652716,0.13122512192593444,1,3,0
8,8,0,0,1,0.0,0,0,16,0,Belgium,441,1.0497295573481775,0.3009051053742676,1,3,0
10,8,0,11,9,88.0,0,0,18,0,Bulgaria,35,0.20545818492870888,1.7639432578951855,2,3,0
3,8,0,1,2,0.0,12,0,11,12,Hong Kong,11,0.5687365297607124,-0.666189838115269,3,0,3
12,8,1,8,10,90.0,3,0,20,4,Chypre,12,-0.8784691234876543,0.49224347653329,0,0,1
4,8,58,2,1,0.0,11,9,12,69,Italy,11,-0.4184974503153522,-1.7494519165359739,3,0,2
4,9,0,0,1,0.0,0,0,13,0,France,331,1.0968776389053825,0.012231054092928698,1,3,0
4,8,0,0,1,0.0,0,0,12,0,France,407,1.3419139293825868,0.025257607180264242,1,3,0
3,8,0,0,1,0.0,0,0,11,0,France,621,1.8211872325051162,-0.5087243978983337,1,3,3
18,10,75,9,7,100.0,49,3,28,124,Italy,11,-1.83980863941773,-0.019493983214208258,0,0,1
6,8,1,2,3,100.0,3,0,14,4,Germany,22,-0.7282278166203306,0.4812202193981336,2,0,1
6,8,1,5,4,100.0,0,0,14,1,Italy,16,-0.39886387028802933,1.034236252353509,2,0,1
5,8,0,0,1,0.0,0,0,13,0,Spain,531,1.2296015562652716,0.13122512192593444,1,3,0
6,8,2,3,2,100.0,0,0,14,2,France,322,-0.3896071550294723,0.9333504547225939,2,0,1
5,8,43,4,2,100.0,0,1,13,43,Germany,14,-0.7269079640797543,0.220888116932983,2,0,1
8,8,11,2,7,100.0,0,0,16,11,Italy,15,-0.5977451980020386,1.0220330051562658,2,0,1
24,17,111,4,12,90.9,27,0,41,138,Italy,12,-1.611794876742845,0.2507164505655237,0,0,1
21,9,7,0,5,80.0,12,4,30,19,Swiss,12,-1.260802028737757,-0.5365404876650381,0,0,1
7,8,1,0,3,0.0,0,0,15,1,Spain,88,0.13121123500346657,0.010833011057177069,3,0,2
5,8,0,0,1,0.0,0,0,13,0,Denmark,284,1.2296015562652716,0.13122512192593444,1,3,0
3,8,5,0,1,0.0,2,0,11,7,Spain,359,0.7457104678008638,-1.8726502427141267,3,0,3
11,8,1,10,9,100.0,0,0,19,1,France,15,-0.6353736694512118,1.2882085408370174,2,0,1
9,8,0,0,1,0.0,0,0,17,0,Spain,699,1.0151362757601352,0.3336331340255293,1,3,0
8,8,1,12,3,100.0,0,0,16,1,Italy,11,-0.5156714132405602,1.1421227252326116,2,0,1
11,8,0,0,1,0.0,0,0,19,0,France,670,0.9598311910461199,0.3854515817640571,1,3,0
11,11,110,3,2,50.0,5,0,22,115,UK,139,-1.2407174813772766,-0.014008213721849192,0,0,1
3,9,0,1,1,0.0,0,0,12,0,France,241,1.2965149917193004,-0.1780780929311491,1,3,3
7,8,0,1,1,0.0,0,0,15,0,Italy,56,0.8676255048808437,0.5586329744394557,1,3,0
12,8,1,2,3,66.0,0,0,20,1,Italy,15,-0.43706006478811316,0.856399820366607,2,0,1
4,8,118,11,2,100.0,0,0,12,118,Spain,13,-0.4228465593920359,0.5720318066613886,2,0,1
36,12,35,60,62,87.0,2,2,48,37,France,12,-1.8994752182451704,0.12884048861298117,0,0,1
15,16,253,1,5,80.0,432,6,31,685,Sweden,15,-1.870612637426418,-0.6510583018417521,0,0,1
20,8,0,0,1,0.0,0,0,28,0,Swiss,652,0.8261692431966401,0.5112159095950021,1,3,0
7,10,1,11,4,75.0,7,0,17,8,Spain,12,-0.9894182755745671,0.18826071606306347,0,0,1
5,8,0,0,1,0.0,0,0,13,0,Germany,206,1.2296015562652716,0.13122512192593444,1,3,0
4,8,0,0,1,0.0,0,0,12,0,Netherlands,660,1.3419139293825868,0.025257607180264242,1,3,0
5,9,7,0,2,100.0,2,3,14,9,France,70,-0.952028317609384,-0.5542374111208875,0,0,1
11,8,0,3,5,83.0,0,0,19,0,France,37,0.23027484356009248,1.7067956519119154,2,3,0
4,8,3,5,2,0.0,0,0,12,3,US,14,0.08620937511829171,0.04005559120230559,3,0,1
5,8,0,0,1,0.0,0,0,13,0,France,698,1.2296015562652716,0.13122512192593444,1,3,0
7,8,2,4,5,0.0,0,0,15,2,France,48,-0.1718542171507006,0.3498281060760287,2,0,1
147,10,77,26,174,74.0,104,1,157,181,UK,11,-2.330461437908711,0.49670331951602453,0,0,1
5,8,0,0,1,0.0,0,0,13,0,France,423,1.2296015562652716,0.13122512192593444,1,3,0
6,8,2,2,5,40.0,170,4,14,172,UK,12,-1.057515332147335,-0.5921948690884385,0,0,1
10,8,14,1,7,85.0,6,0,18,20,France,118,-0.8687416390047245,0.2333767936155433,0,0,1
4,8,1,1,2,0.0,0,0,12,1,France,73,0.16529473978519527,0.04857729512459516,3,0,1
9,8,0,0,6,100.0,0,0,17,0,Italy,97,0.3870786815688116,1.6571283783557378,2,3,0
4,8,0,0,1,0.0,0,3,12,0,France,493,1.0558711913549612,-0.4958782686510219,1,3,0
13,12,7,10,16,87.0,0,0,25,7,Italy,11,-0.9377697391065444,0.8683243950589425,0,0,1
4,8,5,0,1,0.0,13,1,12,18,France,80,-0.053396306038740744,-1.896497280607287,3,0,2
4,8,0,1,2,0.0,0,0,12,0,Italy,599,0.8413762523236227,0.8615684580254663,1,3,0
28,9,11,7,13,84.0,1,0,37,12,France,13,-1.3001745767627906,0.5429826633543994,0,0,1
9,8,1,0,2,100.0,0,1,17,1,Italy,17,-0.5189033871086587,0.28242390122360594,2,0,1
10,10,29,0,3,100.0,9,4,20,38,Spain,11,-1.3380721795710748,-0.45351106928664475,0,0,1
9,8,0,0,1,0.0,0,0,17,0,UK,644,1.0151362757601352,0.3336331340255293,1,3,0
4,8,1,1,2,100.0,0,3,12,1,Germany,16,-0.43845478680140937,0.2414339553856402,2,0,1
7,8,0,0,1,0.0,0,0,15,0,Italy,659,1.0955486418094444,0.2577140011050198,1,3,0
6,8,0,0,2,100.0,4,1,14,4,UK,104,-0.41276119894964886,0.02465482503705737,0,0,1
16,17,14,24,33,87.0,0,0,33,14,Italy,13,-1.1272167970234814,0.9538572057569439,0,0,1
6,8,0,0,1,0.0,29,3,14,29,France,574,0.08046633206628447,-1.3617544702347548,3,0,2
3,8,72,0,1,0.0,0,0,11,72,UK,94,0.9541263986095357,-1.5512314771427416,3,0,3
3,8,2,2,2,0.0,0,0,11,2,Portugal,13,0.6026046032206428,-0.5022297163440722,3,0,3
5,8,0,0,4,100.0,0,0,13,0,Germany,621,0.6137436767289537,1.4307611594907381,2,3,0
18,8,1,4,3,100.0,0,0,26,1,US,201,-0.6925396126982941,1.2989012910897748,2,0,1
18,9,4,7,33,93.0,2,0,27,6,France,16,-1.2118212565987563,0.5472356204350178,0,0,1
8,8,2,0,8,100.0,2,0,16,4,France,37,-0.6315762014181521,0.31315473110423664,2,0,1
12,9,11,2,12,58.0,0,0,21,11,Spain,93,-0.7576039888574986,0.756446254943687,2,0,1
8,8,0,1,1,0.0,4,0,16,4,US,542,0.11171112066165399,-0.33679879594873763,3,0,1
21,8,12,7,44,93.0,9,3,29,21,Italy,11,-1.4356692876138675,0.04628289050086261,0,0,1
7,8,0,0,2,100.0,0,0,15,0,Spain,488,0.5052273131201024,1.5070984147081177,2,3,0
12,8,0,0,1,0.0,0,0,20,0,Spain,670,0.9363231343322683,0.40766584312921156,1,3,0
5,8,15,0,1,0.0,18,1,13,33,Netherlands,606,-0.21080446693739407,-1.8459613000814754,3,0,2
12,9,19,0,7,100.0,2,16,21,21,Belgium,13,-1.32200127058683,-0.33187738125899297,0,0,1
4,8,0,0,2,100.0,0,0,12,0,France,383,0.7515926006932446,1.2746420207833613,2,3,0
6,8,40,1,4,75.0,52,1,14,92,France,59,-1.0470481240109282,-0.5869045463194181,0,0,1
28,52,35,21,10,90.0,1,0,80,36,Italy,11,-1.7033081416224476,0.4943320177972218,0,0,1
4,10,11,0,1,0.0,0,0,14,11,France,13,0.2231832660912425,-0.8976601361712353,3,0,2
14,8,7,5,14,100.0,0,5,22,7,UK,79,-1.0709419492739147,0.7203162184199845,0,0,1
3,8,0,0,1,0.0,0,0,11,0,Belgium,19,1.8211872325051162,-0.5087243978983337,1,3,3
3,8,10,1,1,0.0,0,1,11,10,Belgium,120,0.5564193887510588,-1.6202596877682058,3,0,3
12,8,0,8,16,87.0,0,0,20,0,Spain,22,0.1431811352056103,1.8394271558315798,2,3,0
14,9,5,2,7,85.0,0,0,23,5,Italy,13,-0.7507681709125185,0.8126515993241759,2,0,1
7,8,0,0,1,0.0,1,0,15,1,US,359,0.4341610170989439,-0.6169139311298636,3,0,1
8,10,0,0,1,0.0,349,1,18,349,Germany,11,-0.3805372412345929,-1.4439027974512149,3,0,2
15,8,0,2,6,50.0,0,0,23,0,Belgium,312,0.16890119155026034,1.753426836461142,2,3,0
3,9,3,0,1,0.0,0,0,12,3,France,293,0.8035648438658943,-1.3457865678483352,3,0,3
4,8,32,0,1,0.0,0,1,12,32,Denmark,18,0.24977619604188384,-1.4537314317868686,3,0,2
4,8,4,0,1,0.0,9,3,12,13,Italy,18,-0.0516672696288296,-1.90400633537382,3,0,2
9,9,0,0,1,0.0,2,2,18,2,Belgium,32,-0.1357091836764384,-1.1428062578471574,3,0,2
35,89,35,2,15,60.0,2,0,124,37,France,385,-1.7487052510050944,0.44829192279753977,0,0,1
15,10,10,49,13,92.0,0,0,25,10,Italy,11,-0.9496953259756298,0.9284440122036184,2,0,1
5,8,34,0,2,0.0,0,0,13,34,France,348,0.1287914690555269,-0.3292222133145393,3,0,2
7,11,59,1,2,100.0,10,4,18,69,Netherlands,13,-1.5428640960467748,-0.3054405274006879,0,0,1
5,8,3,0,1,0.0,3,0,13,6,UK,346,0.1623050054353457,-1.2244060964339634,3,0,2
7,8,2,3,4,100.0,4,0,15,6,UK,13,-0.8340118053180734,0.5343057161079537,0,0,1
6,8,1,0,1,0.0,0,0,14,1,Spain,353,0.4792107386002132,-0.6114953933053199,3,0,2
4,8,0,2,2,0.0,0,0,12,0,Italy,14,0.8280582328016545,0.8791517749954065,1,3,0
10,8,0,9,12,100.0,0,0,18,0,UK,12,0.0591375589778782,2.0942295369814357,2,3,0
3,8,0,0,1,0.0,0,1,11,0,UK,87,1.5535504108640927,-0.9963268814024828,1,3,3
3,8,0,0,1,0.0,0,0,11,0,France,612,1.8211872325051162,-0.5087243978983337,1,3,3
23,12,79,1,23,95.0,12,0,35,91,Italy,13,-1.4869914018520212,0.28533759256298696,0,0,1
4,8,0,0,2,100.0,0,0,12,0,UK,275,0.7515926006932446,1.2746420207833613,2,3,0
7,9,18,0,1,0.0,0,0,16,18,US,419,0.1013523770624277,-0.7509694477324671,3,0,2
3,8,0,0,1,0.0,0,0,11,0,France,675,1.8211872325051162,-0.5087243978983337,1,3,3
4,12,81,0,3,66.0,11,4,16,92,Italy,97,-1.1012414620166544,-1.0712030131370727,0,0,1
10,11,21,3,2,0.0,2,0,21,23,US,103,-0.9599292411289879,-0.27967434361260407,0,0,2
3,8,0,0,3,100.0,0,0,11,0,France,503,1.2152245496785867,0.771378311047026,1,3,3
18,11,41,7,11,100.0,2,2,29,43,Germany,11,-1.7798130996721866,0.13423299380476683,0,0,1
5,8,0,0,1,0.0,0,0,13,0,US,616,1.2296015562652716,0.13122512192593444,1,3,0
17,12,65,0,2,100.0,7,7,29,72,UK,67,-1.5329995175281275,-0.44606915395591606,0,0,1
9,8,13,0,1,0.0,1,0,17,14,Germany,642,-0.08379374455723844,-1.056112871406298,3,0,2
7,8,2,0,1,0.0,0,0,15,2,US,28,0.3908217091059035,-0.5896854851558619,3,0,2
4,8,6,2,4,50.0,0,0,12,6,UK,16,-0.11091445050484353,0.3971079170663525,2,0,1
127,40,863,40,87,89.0,68,0,167,931,Italy,11,-2.212549054448231,0.5190233396294757,0,0,1
8,8,1,0,4,50.0,0,0,16,1,US,151,-0.08860022444426038,0.4422382339780147,2,0,1
6,8,20,0,1,0.0,17,2,14,37,Italy,371,-0.3053745820415919,-1.806788168443619,3,0,2
13,13,4,0,2,0.0,0,0,26,4,France,675,-0.41190980672837896,-0.007475055390661071,3,0,1
8,8,5,0,2,0.0,3,0,16,8,France,622,-0.3074887086947745,-0.5399923398668853,3,0,2
4,8,2,0,1,0.0,0,0,12,2,UK,567,0.6371869966790458,-0.8221418790806172,3,0,2
21,8,1,19,11,63.0,0,0,29,1,Italy,30,-0.6494983511624871,1.1169429720827435,2,0,1
4,8,0,0,1,0.0,0,0,12,0,Italy,38,1.3419139293825868,0.025257607180264242,1,3,0
3,10,79,0,1,0.0,1,0,13,80,France,51,0.20852425069211805,-1.9338115732696506,3,0,3
6,8,2,1,2,50.0,0,0,14,2,France,170,-0.21406953690053634,0.5591879242120174,2,0,1
4,8,20,1,2,50.0,1,0,12,21,Ireland,14,-0.44191725651529645,-0.18378524142221597,3,0,1
4,8,0,1,2,100.0,0,0,12,0,Italy,13,0.5236694637646436,1.5755609941177975,2,3,0
5,9,1,0,2,0.0,0,0,14,1,Italy,410,0.06305198085212475,-0.18187423601529576,3,0,2
4,8,1,1,5,100.0,0,0,12,1,France,11,-0.18529291472661416,0.8271450682833257,2,0,1
4,8,1,1,1,0.0,9,0,12,10,US,420,0.04211039434880827,-1.0398474359625962,3,0,2
14,8,3,2,6,50.0,2,0,22,5,Netherlands,22,-0.8735449868786762,0.3963100539476425,0,0,1
5,11,0,0,2,0.0,13,1,16,13,France,135,-0.43353078187460997,-0.8279643041615636,0,0,2
10,10,339,0,9,88.0,31,14,20,370,Australia,40,-1.4082970406829718,-0.9319944138261848,0,0,1
5,8,0,0,1,0.0,0,0,13,0,Netherlands,699,1.2296015562652716,0.13122512192593444,1,3,0
3,8,0,0,1,0.0,0,0,11,0,France,610,1.8211872325051162,-0.5087243978983337,1,3,3
25,10,0,1,26,100.0,0,0,35,0,Italy,40,-0.3549389855886903,2.1848150624643465,2,3,0
3,8,0,1,1,0.0,0,1,11,0,UK,58,1.3256272739354913,-0.6954079080680469,1,3,3
7,10,118,0,1,0.0,7,0,17,125,Austria,14,-0.4169406709290636,-1.3646987973652562,3,0,2
46,19,1308,63,87,92.0,564,36,65,1872,Spain,11,-2.42337785982768,-0.30525695778111894,0,0,1
6,8,14,0,2,100.0,1,3,14,15,France,11,-0.8237293291663638,-0.4644799559566526,0,0,1
3,8,0,4,2,0.0,0,0,11,0,France,12,1.291392172201343,0.36621395626715747,1,3,3
10,8,4,0,10,70.0,0,0,18,4,France,180,-0.2422780578933915,0.5006755280857007,2,0,1
4,8,0,0,4,75.0,0,0,12,0,Italy,105,0.8729465669029083,0.9946819298620404,1,3,0
4,8,0,0,1,0.0,0,0,12,0,France,645,1.3419139293825868,0.025257607180264242,1,3,0
13,8,0,1,8,87.0,0,0,21,0,UK,29,0.1923365633569032,1.7512608192320758,2,3,0
7,8,3,0,1,0.0,0,0,15,3,Netherlands,60,0.37467535702743726,-0.6090755004777301,3,0,2
41,85,69,12,17,58.0,0,0,126,69,Italy,14,-1.5079022669194928,0.9500370152188008,0,0,1
4,8,0,2,3,100.0,0,0,12,0,UK,390,0.4947100901054875,1.6238626064300006,2,3,0
51,9,66,13,65,90.0,1,0,60,67,Spain,11,-1.5814362774451551,0.6854517923587752,0,0,1
6,8,0,2,4,50.0,0,0,14,0,France,18,0.4518028254340603,1.474322351404546,2,3,0
6,8,0,2,4,50.0,0,0,14,0,Belgium,57,0.4518028254340603,1.474322351404546,2,3,0
8,8,0,4,7,85.0,0,0,16,0,France,88,0.3018193608263879,1.6540018978484006,2,3,0
205,2013,35,3,1,0.0,4,0,2218,39,France,45,-1.8281577877368478,-0.15441415184958296,0,0,1
8,8,0,0,1,0.0,0,0,16,0,France,686,1.0497295573481775,0.3009051053742676,1,3,0
9,8,0,0,1,0.0,0,0,17,0,France,693,1.0151362757601352,0.3336331340255293,1,3,0
27,17,699,8,14,64.0,2,28,44,701,Netherlands,11,-2.0265327310642416,-0.38838042794046035,0,0,1
4,8,1,0,3,66.0,0,0,12,1,France,254,0.20977188671277452,0.15548929411328324,2,0,1
11,13,3,1,2,0.0,0,0,24,3,Italy,37,-0.5975978248071925,0.2780819975910973,0,0,1
21,9,12,7,10,80.0,0,0,30,12,Italy,15,-0.9035659191088411,0.8992323662476602,2,0,1
7,8,0,6,2,0.0,0,1,15,0,Lituanie,221,0.28911982463813907,0.6569282117541313,2,3,0
8,8,0,3,1,0.0,0,0,16,0,France,11,0.799878412572948,0.6307748631590948,1,3,0
18,15,10,0,1,0.0,66,0,33,76,Italy,139,-0.6947974560827821,-1.1312204889709232,3,0,2
16,15,1,4,18,44.0,3,0,31,4,Italy,30,-1.2725681860633031,0.4453296469769695,0,0,1
4,8,0,0,1,0.0,0,0,12,0,Spain,386,1.3419139293825868,0.025257607180264242,1,3,0
8,0,1,1,2,100.0,0,0,8,1,France,17,0.8334427501500071,0.9265200616554001,2,1,2
6,9,2,1,1,0.0,2,1,15,4,France,357,-0.5936065674945908,-1.3560367172459764,3,0,2
4,8,0,0,2,100.0,0,0,12,0,France,597,0.7515926006932446,1.2746420207833613,2,3,0
5,8,0,0,2,0.0,0,0,13,0,Spain,581,0.9569870161349087,0.6666169994367005,1,3,0
4,8,0,0,1,0.0,0,0,12,0,US,507,1.3419139293825868,0.025257607180264242,1,3,0
5,8,0,2,2,0.0,0,0,13,0,Italy,366,0.7157458596843388,0.9851192897410775,1,3,0
4,8,0,0,2,100.0,0,0,12,0,Italy,231,0.7515926006932446,1.2746420207833613,2,3,0
28,9,11,17,26,82.6,0,0,37,11,Italy,11,-1.0199454289427945,1.056713829703935,2,0,1
10,8,0,3,15,93.0,0,1,18,0,Sweden,11,-0.05317911358520711,1.2798897128091349,2,3,0
56,8,727,4,66,83.0,16,0,64,743,France,11,-1.587319739266847,0.49992374091359487,0,0,1
4,8,2,0,1,0.0,1,0,12,3,Italy,11,0.31295873171851213,-1.2806092005130094,3,0,2
45,8,0,17,84,98.7,0,0,53,0,Italy,11,-0.2271975473599212,2.2575922113863602,2,3,0
5,9,63,0,1,0.0,1,0,14,64,France,188,-0.16389487337179795,-1.3862081591167204,3,0,2
29,8,0,3,3,0.0,0,0,37,0,France,658,0.19865078156720659,1.4912513705510329,2,3,0
3,8,0,0,1,0.0,0,0,11,0,Finland,19,1.8211872325051162,-0.5087243978983337,1,3,3
3,8,4,0,1,0.0,0,0,11,4,France,138,1.0880433111556682,-1.3902393007833027,3,0,3
4,5,82,0,2,0.0,0,8,9,82,France,573,0.50388360536616,-1.1882997325149973,3,0,2
42,9,0,0,3,0.0,0,0,51,0,US,690,0.20220661951460772,1.1595411919175007,2,3,0
23,8,10,6,16,100.0,1,0,31,11,France,12,-1.219941850082082,0.90295896362615,0,0,1
3,8,1,1,1,0.0,0,0,11,1,Belgium,596,0.9171825830380881,-1.0207965874647678,3,0,3
4,9,2,0,2,66.0,0,0,13,2,France,320,-0.04826846979235619,0.07733612232367473,2,0,1
6,8,11,1,8,87.0,0,2,14,11,UK,11,-0.6205756053314806,0.0871204335852535,0,0,1
5,8,0,1,2,100.0,0,0,13,0,Netherlands,84,0.4113570906473284,1.6815285088634675,2,3,0
18,8,16,4,28,100.0,0,0,26,16,Italy,11,-0.8797776269849623,1.3016649326724092,2,0,1
8,8,0,0,1,0.0,0,0,16,0,Romania,599,1.0497295573481775,0.3009051053742676,1,3,0
6,8,0,5,17,94.0,0,0,14,0,Italy,72,0.36720571789735273,1.6318900012363518,2,3,0
6,8,0,1,3,0.0,0,0,14,0,France,524,0.6391132199424889,1.0685249157830152,1,3,0
58,8,2,62,50,100.0,0,0,66,2,Italy,11,-1.134370887454305,1.7713676143292107,2,0,1
6,8,0,0,2,0.0,0,0,14,0,France,43,0.8826777110082771,0.7368876471063168,1,3,0
8,8,0,0,1,0.0,0,0,16,0,UK,551,1.0497295573481775,0.3009051053742676,1,3,0
4,8,17,2,1,0.0,3,0,12,20,UK,11,-0.02995628960531518,-1.0876721586497233,3,0,2
47,8,13,25,43,93.0,19,0,55,32,Italy,11,-1.3917465773175717,0.7453342569861484,0,0,1
5,8,12,0,1,0.0,18,1,13,30,UK,265,-0.20326684993742228,-1.8369843216459276,3,0,2
5,10,61,0,3,66.0,13,0,15,74,France,14,-0.7560416420136382,-0.49440787293637495,0,0,1
5,8,5,1,3,66.0,0,0,13,5,Netherlands,225,-0.19634769691071255,0.4832473037535269,2,0,1
8,8,46,1,5,100.0,15,4,16,61,Denmark,11,-1.3054305651727485,-0.151525172033822,0,0,1
6,8,68,3,3,66.0,10,0,14,78,Grèce,11,-0.7701409495602323,-0.06791603873552415,0,0,1
4,9,118,2,1,0.0,4,3,13,122,US,14,-0.6622349118581635,-1.744396663119401,3,0,2
6,14,0,0,1,0.0,0,0,20,0,Belgium,426,0.7197626227547773,0.1974688503734844,1,3,0
4,8,0,1,1,0.0,0,0,12,0,Italy,364,1.1139907924539858,0.3261765805147003,1,3,0
4,9,2,1,1,0.0,5,0,13,7,Spain,48,-0.20150638586414932,-1.04843208810486,3,0,2
5,8,0,0,1,0.0,0,0,13,0,France,468,1.2296015562652716,0.13122512192593444,1,3,0
5,8,0,1,1,0.0,0,0,13,0,France,647,1.0016784193366708,0.43214409526037056,1,3,0
4,8,13,0,3,66.0,5,2,12,18,France,11,-0.5226876523248207,-0.9718466081157905,3,0,1
40,174,13,0,5,100.0,1900,41,214,1913,Bulgaria,112,-2.3423910366034613,-0.5477120429652133,0,0,1
7,8,52,2,2,50.0,61,0,15,113,Italy,15,-0.8331456728783315,-0.10665132819898297,0,0,1
18,14,83,3,14,100.0,16,0,32,99,Croatie,11,-1.6276220100323853,0.5358430723791265,0,0,1
23,8,0,0,13,100.0,0,0,31,0,US,161,0.140703780246301,1.9157934197906321,2,3,0
4,9,5,0,1,0.0,0,1,13,5,UK,11,0.08727523114835953,-1.3674910707519545,3,0,2
3,9,6,0,3,100.0,1,0,12,7,Netherlands,20,-0.15055132973320123,-0.5527336163374985,3,0,3
13,8,1,1,9,100.0,0,0,21,1,France,116,-0.6287588597138982,1.2630022970923431,2,0,1
25,12,58,4,9,80.0,11,0,37,69,Portugal,11,-1.4769694600632135,0.28751348889703204,0,0,1
3,8,0,0,1,0.0,0,0,11,0,UK,330,1.8211872325051162,-0.5087243978983337,1,3,3
6,8,0,3,1,0.0,0,0,14,0,France,36,0.9054411063634108,0.5313655273803783,1,3,0
4,9,2,0,1,0.0,0,0,13,2,Australia,86,0.3921507062018414,-0.835168432167953,3,0,2
4,8,0,0,1,0.0,0,0,12,0,US,608,1.3419139293825868,0.025257607180264242,1,3,0
3,8,0,0,1,0.0,0,0,11,0,France,692,1.8211872325051162,-0.5087243978983337,1,3,3
5,8,0,0,1,0.0,0,0,13,0,Italy,18,1.2296015562652716,0.13122512192593444,1,3,0
6,8,0,0,2,0.0,0,0,14,0,US,385,0.8826777110082771,0.7368876471063168,1,3,0
23,8,0,0,2,0.0,0,0,31,0,US,642,0.5223353024076247,1.0762581187145668,1,3,0
4,8,1,0,1,0.0,0,0,12,1,US,572,0.6658324168441594,-0.7877335557206065,3,0,2
3,8,16,0,1,0.0,2,0,11,18,US,232,0.7006710777985832,-1.9266623911195564,3,0,3
3,9,1,4,3,100.0,1,1,12,2,Spain,15,-0.6128469390001582,-0.6260557531590999,0,0,3
3,8,0,0,1,0.0,0,0,11,0,France,483,1.8211872325051162,-0.5087243978983337,1,3,3
3,8,14,4,1,0.0,4,2,11,18,Italy,11,0.15688920843560053,-2.107015362734714,3,0,3
4,8,0,0,2,0.0,0,0,12,0,Italy,131,1.0692993892522236,0.5606494846910302,1,3,0
10,8,2,2,13,92.3,0,0,18,2,Italy,12,-0.47633601650561,0.8981583387977917,2,0,1
14,9,0,1,7,100.0,0,0,23,0,UK,100,-0.13748245333963677,2.0063042783665153,2,3,0
11,8,1,3,2,0.0,0,0,19,1,US,467,-0.2387160063979002,0.4377220541587793,2,0,1
11,10,79,0,2,100.0,70,12,21,149,US,75,-1.460535066434764,-0.6241024607715298,0,0,1
8,15,52,1,1,0.0,7,0,23,59,Denmark,22,-0.7796578062536046,-0.9530356788102193,3,0,2
6,10,10,4,3,0.0,0,0,16,10,France,14,-0.4483394748785318,0.14292950604191337,2,0,1
16,8,2,1,4,100.0,0,0,24,2,France,381,-0.6785899360494224,1.2234380375927592,2,0,1
5,8,2,5,4,100.0,1,0,13,3,France,11,-0.6774282502870456,0.47108995989148966,2,0,1
3,8,0,1,1,0.0,0,0,11,0,Italy,618,1.593264095576516,-0.20780542456389742,1,3,3
37,8,3,0,20,90.0,0,0,45,3,Italy,407,-0.5663077033800159,0.867491749266587,2,0,1
35,9,2,185,87,94.0,2,0,44,4,Italy,11,-1.4532564314311962,0.8889049590328858,0,0,1
7,8,0,0,1,0.0,0,0,15,0,Italy,630,1.0955486418094444,0.2577140011050198,1,3,0
13,14,12,5,12,58.0,3,1,27,15,UK,11,-1.5655703389094267,-0.1856108704129146,0,0,1
3,8,1,0,4,75.0,0,0,11,1,France,634,0.6761383574870106,-0.35229123811742774,3,0,3
11,8,2,0,2,100.0,0,0,19,2,Italy,30,-0.3352170703467634,0.7874365091062725,2,0,1
3,8,14,0,1,0.0,9,1,11,23,Sweden,12,0.4060492764469009,-2.452127159508804,3,0,3
7,8,0,13,4,100.0,0,0,15,0,Italy,11,0.19470671040346685,1.9335045491198533,2,3,0
4,8,4,1,3,100.0,0,0,12,4,France,12,-0.225115811721992,0.7247643865750905,2,0,1
7,8,0,1,2,100.0,0,0,15,0,Italy,12,0.2773041761915014,1.8080173880425532,2,3,0
14,22,46,8,8,62.0,139,3,36,185,France,107,-1.856112606294461,-0.4048925719531969,0,0,1
5,8,1,7,9,66.0,3,0,13,4,Spain,11,-0.567407726940897,0.17995342863864938,2,0,1
4,8,0,0,1,0.0,0,0,12,0,France,616,1.3419139293825868,0.025257607180264242,1,3,0
5,8,15,6,3,66.0,0,1,13,15,Germany,14,-0.5480368204204512,-0.008910947624300723,2,0,1
10,8,65,4,8,37.0,12,2,18,77,Belgium,11,-1.2529082439034496,-0.36361134823830166,0,0,1
3,8,0,1,1,0.0,0,0,11,0,France,338,1.593264095576516,-0.20780542456389742,1,3,3
3,8,0,0,1,0.0,0,0,11,0,UK,671,1.8211872325051162,-0.5087243978983337,1,3,3
8,8,0,0,1,0.0,0,0,16,0,France,329,1.0497295573481775,0.3009051053742676,1,3,0
7,8,55,0,2,0.0,1,1,15,56,UK,11,-0.6139878182201404,-1.1688318447965027,3,0,1
5,8,24,0,1,0.0,0,0,13,24,Netherlands,341,0.4190786185286718,-0.8433620679895923,3,0,2
14,10,241,1,1,0.0,23,0,24,264,Italy,98,-0.870744378729362,-0.991738949717364,3,0,2
4,8,1,3,2,0.0,0,0,12,1,Italy,157,0.14336673193856667,0.07752807957498649,3,0,1
8,8,1,0,1,0.0,0,0,16,1,France,493,0.37364804480975017,-0.5120860575266034,3,0,2
4,8,0,0,1,0.0,0,0,12,0,Swiss,652,1.3419139293825868,0.025257607180264242,1,3,0
3,8,3,0,2,0.0,2,2,11,5,France,21,0.2118341554782338,-1.8243813911661884,3,0,3
4,8,0,1,1,0.0,0,0,12,0,UK,116,1.1139907924539858,0.3261765805147003,1,3,0
6,8,0,6,6,100.0,0,0,14,0,Italy,11,0.26105720154739886,1.876415830568254,2,3,0
6,9,2,0,1,0.0,0,1,15,2,UK,64,-0.025444028755246536,-1.1768447451341875,3,0,2
11,8,1,1,2,100.0,6,1,19,7,Italy,137,-1.1845058394365882,0.09995930239529822,0,0,1
3,8,1,3,1,0.0,0,0,11,1,Italy,84,0.8952545751914595,-0.9918458030143769,3,0,3
13,22,16,0,1,0.0,0,0,35,16,Italy,216,-0.3120130487900037,-0.5826343458271247,3,0,2
14,8,88,0,5,100.0,7,14,22,95,US,154,-1.2642711178798687,-0.36596534069378217,0,0,1
6,9,1,0,1,0.0,1,2,15,2,France,25,-0.3385995128983304,-1.6292788709297257,3,0,2
4,8,1,0,1,0.0,0,0,12,1,France,404,0.6658324168441594,-0.7877335557206065,3,0,2
9,8,3,5,41,78.0,1,1,17,4,UK,11,-1.1006720809329036,-0.015497176159152557,0,0,1
4,8,0,0,4,100.0,0,0,12,0,France,60,0.7260560498462685,1.3247936447450677,2,3,0
3,8,0,0,1,0.0,0,0,11,0,France,487,1.8211872325051162,-0.5087243978983337,1,3,3
3,8,0,0,1,0.0,0,0,11,0,France,576,1.8211872325051162,-0.5087243978983337,1,3,3
3,8,0,1,1,0.0,0,0,11,0,France,17,1.593264095576516,-0.20780542456389742,1,3,3
25,52,733,0,3,0.0,67,11,77,800,Italy,13,-1.7349399238411107,-1.2587887396821862,0,0,1
7,8,1,1,2,0.0,0,0,15,1,Italy,13,-0.08107054778794687,0.28103368904935067,2,0,1
6,8,0,0,1,0.0,0,0,14,0,UK,399,1.1552922511386405,0.2014957695955509,1,3,0
35,10,9,7,22,88.8,7,4,45,16,Italy,11,-1.743323634305162,0.028695426385007793,0,0,1
15,8,0,2,21,80.0,0,0,23,0,France,509,0.11979634361088802,1.852364340580363,2,3,0
8,9,118,0,2,100.0,25,4,17,143,Italy,17,-1.2907647444840997,-0.6445877215124765,0,0,1
5,8,0,0,1,0.0,0,0,13,0,UK,162,1.2296015562652716,0.13122512192593444,1,3,0
6,8,12,7,2,100.0,0,0,14,12,Portugal,11,-0.482873323087727,0.8724878498068721,2,0,1
4,8,5,1,1,0.0,0,0,12,5,France,220,0.3720252063379874,-0.5659430608260333,3,0,2
9,8,0,10,10,100.0,0,0,17,0,US,36,0.09227619934186239,2.0567198743454416,2,3,0
5,9,1,0,1,0.0,0,0,14,1,Kazakhstan,11,0.33566652098248795,-0.7172661135260614,3,0,2
62,16,91,8,27,41.6,106,8,78,197,Sweden,11,-2.1183812894107317,-0.1461171481036381,0,0,1
3,8,0,0,1,0.0,15,3,11,15,UK,62,0.7733396753832082,-2.0367387740793945,3,0,3
3,8,0,0,1,0.0,0,0,11,0,Austria,670,1.8211872325051162,-0.5087243978983337,1,3,3
5,8,5,1,1,0.0,0,0,13,5,Spain,439,0.25971283322067235,-0.45997554608036273,3,0,2
11,8,27,0,1,0.0,25,7,19,52,Germany,12,-0.5447070044731392,-1.6911658447734346,3,0,2
7,8,0,10,8,100.0,1,0,15,1,US,40,-0.48086335500484717,1.090784149280187,2,0,1
4,8,0,0,1,0.0,0,2,12,0,France,675,1.062899733902033,-0.48307309939085413,1,3,0
3,8,0,0,1,0.0,0,0,11,0,UK,48,1.8211872325051162,-0.5087243978983337,1,3,3
6,8,135,8,2,0.0,20,1,14,155,Italy,15,-0.9303295387071117,-0.9982057707454021,0,0,1
10,8,8,6,3,66.0,8,4,18,16,France,11,-1.1514513018907044,-0.3038219559821205,0,0,1
3,8,0,0,1,0.0,3,19,11,3,France,22,0.7999739604788808,-2.0195358173639755,3,0,3
11,9,2,0,1,0.0,0,0,20,2,Italy,427,0.07273280536123004,-0.5267829952209114,3,0,2
7,8,0,7,6,100.0,0,0,15,0,Italy,14,0.1973342403058381,1.937887861705711,2,3,0
4,8,0,0,1,0.0,0,1,12,0,France,14,1.0742771077415623,-0.4623448763238852,1,3,0
28,17,19,0,2,100.0,1,0,45,20,US,231,-1.3049918845115878,0.31912998285538513,0,0,1
11,11,2280,1,1,0.0,0,70,22,2280,France,11,-0.9865411840349584,-1.3362003774833766,3,0,2
4,8,0,3,1,0.0,0,0,12,0,France,32,1.0920627846073574,0.3551273649650917,1,3,0
43,12,204,40,34,96.2,1,0,55,205,Italy,12,-1.7245507397859285,0.5434709056749351,0,0,1
4,8,0,0,1,0.0,0,0,12,0,France,420,1.3419139293825868,0.025257607180264242,1,3,0
5,8,3,1,6,50.0,0,0,13,3,Italy,45,-0.19364284935435291,0.5436380919476436,2,0,1
4,8,0,0,1,0.0,0,0,12,0,France,658,1.3419139293825868,0.025257607180264242,1,3,0
6,8,0,10,3,100.0,0,0,14,0,Italy,11,0.2706446204603647,1.8495365015138865,2,3,0
6,8,0,0,1,0.0,0,0,14,0,Swiss,255,1.1552922511386405,0.2014957695955509,1,3,0
94,9,5,10,33,28.0,0,0,103,5,Italy,77,-1.1911388447548374,1.280058860272065,0,0,1
5,8,1,3,5,100.0,0,0,13,1,Grèce,79,-0.319533295690558,0.9620633674793878,2,0,1
4,8,0,0,1,0.0,0,3,12,0,UK,11,1.0558711913549612,-0.4958782686510219,1,3,0
5,5,0,0,1,0.0,0,0,10,0,France,505,1.9039539098763856,-0.06344546008016544,1,3,2
3,10,0,1,1,0.0,3,1,13,3,France,97,0.20207292874713054,-1.5476252582294525,3,0,3
6,8,0,0,1,0.0,0,0,14,0,Italy,620,1.1552922511386405,0.2014957695955509,1,3,0
3,8,0,0,2,0.0,0,0,11,0,France,466,1.5485726923747536,0.02666747961243265,1,3,3
8,11,26,4,4,75.0,14,20,19,40,Italy,49,-1.4908863610141292,-0.544507461765075,0,0,1
8,8,1,9,6,100.0,0,0,16,1,France,16,-0.5307485782704396,1.176249974737837,2,0,1
15,8,0,23,17,88.0,0,0,23,0,Spain,13,0.06351703030586067,1.9267487206957479,2,3,0
5,8,27,3,1,0.0,0,0,13,27,UK,185,0.16389760718012206,-0.5199082898870085,3,0,2
12,8,2,1,6,80.0,0,0,20,2,Italy,51,-0.4795949463191515,0.8592903549608507,2,0,1
21,9,97,3,13,84.0,10,16,30,107,UK,42,-1.6736809307911205,-0.3114733391876363,0,0,1
176,60,276,18,81,92.0,1,0,236,277,Spain,11,-2.146325367685686,0.7450875610267197,0,0,1
5,8,1,0,3,100.0,2,1,13,3,Italy,203,-0.6685541876365158,-0.3795417402944753,0,0,1
5,8,0,0,1,0.0,0,0,13,0,France,644,1.2296015562652716,0.13122512192593444,1,3,0
3,10,0,3,3,100.0,0,0,13,0,Italy,87,0.5412531949853371,1.17359879067756,2,3,3
5,8,0,0,1,0.0,0,0,13,0,France,333,1.2296015562652716,0.13122512192593444,1,3,0
4,8,21,1,1,0.0,1,0,12,22,UK,11,-0.0075006075102343845,-1.0907146713464078,3,0,2
8,8,1,0,1,0.0,0,0,16,1,US,638,0.37364804480975017,-0.5120860575266034,3,0,2
5,8,7,1,1,0.0,0,0,13,7,UK,18,0.24592247290600605,-0.47655015577002674,3,0,2
5,8,1,0,1,0.0,0,0,13,1,UK,169,0.5535200437268443,-0.6817660409749363,3,0,2
4,8,0,0,1,0.0,0,0,12,0,Italy,388,1.3419139293825868,0.025257607180264242,1,3,0
7,0,133,1,1,0.0,0,2,7,133,Germany,11,0.9466585695754799,-1.1293613731601337,3,1,2
3,8,26,0,1,0.0,0,0,11,26,Belgium,17,1.007298787514313,-1.4873687250975898,3,0,3
4,9,1,0,2,0.0,0,0,13,1,France,478,0.14818158623659175,-0.26536823129717635,3,0,2
20,8,7,10,13,61.0,2,5,28,9,France,11,-1.3387256385767088,-0.00394190680113871,0,0,1
4,8,4,0,2,0.0,2,0,12,6,France,13,0.001492190902495604,-0.7940936731855542,3,0,2
7,9,0,0,2,0.0,0,0,16,0,France,471,0.6246540164202253,0.7414233469189679,1,3,0
17,8,0,0,12,83.0,0,1,25,0,Pologne,55,0.08311734092697776,1.0401005120194422,2,3,0
23,9,1,1,4,100.0,0,0,32,1,Spain,586,-0.8996091431958837,1.2571496483900213,2,0,1
5,8,4,3,1,0.0,0,0,13,4,UK,378,0.24660649014059377,-0.42042002317420774,3,0,2
5,10,91,0,1,0.0,5,5,15,96,UK,70,-0.598239111396141,-1.9757157028431322,3,0,2
5,8,0,0,2,0.0,0,0,13,0,UK,663,0.9569870161349087,0.6666169994367005,1,3,0
4,8,0,0,1,0.0,0,0,12,0,France,11,1.3419139293825868,0.025257607180264242,1,3,0
24,21,57,39,11,81.0,859,16,45,916,Italy,11,-2.1170505538405715,-0.4287861296701135,0,0,1
10,8,0,5,9,100.0,0,0,18,0,US,16,0.08409895138566907,2.0542972963708737,2,3,0
13,9,20,0,12,91.0,3,2,22,23,UK,84,-1.1911313971000361,-0.5313415726432866,0,0,1
4,8,0,1,1,0.0,0,0,12,0,Croatie,96,1.1139907924539858,0.3261765805147003,1,3,0
4,8,5,0,1,0.0,0,0,12,5,France,302,0.5999483432665885,-0.8668620341604695,3,0,2
5,8,0,0,1,0.0,0,0,13,0,France,631,1.2296015562652716,0.13122512192593444,1,3,0
9,10,35,3,3,0.0,0,0,19,35,Croatie,11,-0.606797845927266,0.16353509429650417,0,0,1
3,9,11,1,1,0.0,3,7,12,14,France,11,-0.11700888481974578,-2.136845424761483,3,0,3
4,8,4,0,1,0.0,7,3,12,11,UK,188,-0.0435659461886875,-1.893205995616538,3,0,2
9,9,1,0,4,75.0,0,0,18,1,UK,219,-0.31610977656821737,0.4283941440681064,2,0,1
3,8,2,0,1,0.0,2,0,11,4,France,360,0.7762208979908322,-1.8362348296054394,3,0,3
7,8,0,1,3,100.0,0,0,15,0,France,11,0.261662822054314,1.8387356833848152,2,3,0
3,8,0,2,2,0.0,0,0,11,0,France,394,1.3073315359241837,0.34516976991680937,1,3,3
3,8,5,1,1,0.0,0,1,11,5,France,15,0.5836616878194928,-1.5875275494087802,3,0,3
6,8,0,0,7,85.0,0,0,14,0,France,72,0.6645625747902613,1.2150460854149587,2,3,0
14,8,1,3,8,62.0,0,0,22,1,Italy,15,-0.5110689400108239,0.9587819337026644,2,0,1
4,8,0,0,4,0.0,0,0,12,0,UK,683,1.0437628384052475,0.6108011086527365,1,3,0
6,8,36,3,1,0.0,2,1,14,38,Grèce,22,-0.5223955858503493,-1.421911845361908,3,0,2
5,8,1,0,2,100.0,5,47,13,6,France,260,-0.7529969134881241,-0.5787558300935418,0,0,1
7,8,0,0,4,75.0,0,0,15,0,Austria,214,0.626581279329766,1.227138323786796,2,3,0
14,10,65,20,20,90.0,117,3,24,182,UK,11,-1.7269002343431799,-0.3145112356639653,0,0,1
5,8,0,0,5,100.0,0,0,13,0,Italy,204,0.6063993616230989,1.4451847725954305,2,3,0
7,8,0,0,2,100.0,0,0,15,0,Germany,35,0.5052273131201024,1.5070984147081177,2,3,0
4,8,6,1,1,0.0,7,1,12,13,Islande,31,-0.2649710088467986,-1.5728985720039559,3,0,2
9,8,7,1,3,66.0,0,0,17,7,France,13,-0.42460333773051506,0.6690807061634578,2,0,1
5,22,29,20,2,100.0,0,0,27,29,France,11,-1.074789454314322,0.8629124570078741,0,0,1
8,8,0,0,1,0.0,0,0,16,0,Estonie,652,1.0497295573481775,0.3009051053742676,1,3,0
15,8,2,3,7,71.0,1,0,23,3,UK,33,-0.8788197485741044,0.4804272984774905,0,0,1
4,8,0,1,1,0.0,0,0,12,0,Spain,378,1.1139907924539858,0.3261765805147003,1,3,0
3,8,21,0,4,75.0,0,2,11,21,Italy,27,0.269228128376005,-1.0143424057680623,3,0,3
4,8,0,0,1,0.0,0,0,12,0,US,681,1.3419139293825868,0.025257607180264242,1,3,0
5,9,69,0,1,0.0,3,0,14,72,UK,14,-0.18633502217789144,-1.4167142031645967,3,0,2
5,8,3,0,2,0.0,0,0,13,3,France,376,0.23611373135290106,-0.20017250214604967,3,0,2
17,8,1,35,31,93.0,2,0,25,3,France,11,-1.0192507889202285,0.7066042583526232,0,0,1
3,10,2,1,1,0.0,0,0,13,2,France,268,0.4644169529549542,-0.9828541889790727,3,0,3
31,8,6,1,24,76.0,0,0,39,6,Spain,13,-0.787830619140421,1.0978306518339,2,0,1
4,8,1,0,1,0.0,0,0,12,1,Italy,257,0.6658324168441594,-0.7877335557206065,3,0,2
42,79,1127,0,4,0.0,8,0,121,1135,Spain,62,-1.526635935982457,-0.5875098824345394,0,0,2
4,9,0,0,1,0.0,0,0,13,0,France,650,1.0968776389053825,0.012231054092928698,1,3,0
48,8,9,0,30,93.0,1,0,56,10,France,131,-1.0028401845226131,0.4505322290901485,0,0,1
3,8,0,0,1,0.0,0,0,11,0,Italy,11,1.8211872325051162,-0.5087243978983337,1,3,3
4,8,0,0,1,0.0,0,0,12,0,France,314,1.3419139293825868,0.025257607180264242,1,3,0
3,9,1,0,1,0.0,0,0,12,1,France,618,0.8483566161094743,-1.2919882291664566,3,0,3
14,17,160,0,2,100.0,187,5,31,347,France,11,-1.7036262414147094,-0.6288864433726068,0,0,1
7,8,0,0,2,100.0,0,0,15,0,France,561,0.5052273131201024,1.5070984147081177,2,3,0
3,8,0,0,1,0.0,0,0,11,0,UK,632,1.8211872325051162,-0.5087243978983337,1,3,3
7,9,22,0,1,0.0,11,0,16,33,US,41,-0.27367078315916693,-1.2787491792345083,3,0,2
3,8,1,0,2,0.0,0,0,11,1,France,61,0.8724911798363258,-0.7863236832884385,3,0,3
8,8,8,3,2,0.0,0,5,16,8,Sweden,11,-0.5303271927262884,-0.28886220332928214,3,0,1
5,7,3,2,1,0.0,11,0,12,14,France,13,0.22856154464161885,-0.897233067766133,3,0,2
6,9,169,0,2,100.0,103,3,15,272,Germany,52,-1.2497479383773311,-0.7854437411476849,0,0,1
4,8,0,0,1,0.0,0,0,12,0,France,167,1.3419139293825868,0.025257607180264242,1,3,0
3,8,50,0,1,0.0,8,0,11,58,UK,33,0.6223303911282699,-2.025547685810169,3,0,3
3,8,0,12,6,100.0,0,0,11,0,France,11,0.9097728630900123,1.1888769202457308,2,3,3
7,8,0,3,2,100.0,0,0,15,0,France,132,0.2553761683448727,1.8369681724929443,2,3,0
3,8,0,2,1,0.0,12,0,11,12,US,692,0.828033050369107,-1.1839983986560945,3,0,3
82,12,150,5,37,50.0,7,5,94,157,UK,106,-2.0654965443037634,-0.02286643427627915,0,0,1
4,8,4,0,2,100.0,0,1,12,4,UK,150,-0.2491881422972283,-0.09447536560575764,2,0,1
6,8,0,3,1,0.0,0,0,14,0,France,184,0.9054411063634108,0.5313655273803783,1,3,0
36,19,5598,2,4,0.0,1295,18,55,6893,Spain,12,-2.1200499998533773,-1.1825238721357434,0,0,1
5,8,0,1,1,0.0,0,0,13,0,US,319,1.0016784193366708,0.43214409526037056,1,3,0
12,9,15,17,10,100.0,0,0,21,15,France,22,-0.9654610709245122,1.131451951225116,2,0,1
6,8,3,38,4,50.0,1,0,14,4,France,11,-0.659755178710952,0.24201716298126308,0,0,1
5,8,1,0,1,0.0,0,0,13,1,Italy,359,0.5535200437268443,-0.6817660409749363,3,0,2
9,8,0,1,4,75.0,1,0,17,1,Italy,141,-0.34314184835864464,0.7293484978068584,2,0,1
9,10,34,3,9,77.0,1,0,19,35,Russia,15,-1.128803221865855,0.16994652058736961,0,0,1
5,8,2,0,1,0.0,2,0,13,4,Italy,496,0.18463522175098723,-1.1962853097811712,3,0,2
4,8,17,3,4,100.0,0,0,12,17,Italy,11,-0.3177609996347087,0.7000260222724344,2,0,1
6,34,4,1,8,87.0,20,32,40,24,France,22,-1.712071800717408,-0.43583013913008994,0,0,1
5,8,0,2,1,0.0,0,0,13,0,France,13,0.9883603998147023,0.4497274122303112,1,3,0
12,8,0,0,17,70.0,0,0,20,0,France,14,0.42251503440856925,1.4647578170412694,2,3,0
5,8,1,0,9,100.0,0,0,13,1,UK,11,-0.08691835638031405,0.6660440580259189,2,0,1
6,8,0,0,3,100.0,0,0,14,0,France,13,0.5493295683121108,1.4815984785409104,2,3,0
12,9,462,1,2,0.0,1,5,21,463,Germany,14,-1.329492396662994,-0.9804597596433875,0,0,1
9,9,26,19,4,75.0,0,24,18,26,Italy,11,-1.0731349953236604,0.05425611787773405,0,0,1
12,8,1,1,11,100.0,0,0,20,1,Germany,146,-0.6153943334097395,1.257690093999441,2,0,1
6,8,1,0,2,50.0,0,0,14,1,Italy,422,0.04249902019317821,0.2926772742375918,2,0,1
12,8,25,4,3,66.0,0,0,20,25,France,13,-0.5891148252433532,0.7138299974270532,2,0,1
10,8,30,2,7,57.0,0,2,18,30,UK,11,-0.8350730390434542,0.173564084712163,0,0,1
16,8,0,7,14,92.0,0,0,24,0,Sweden,15,0.08048530265685643,1.8979436223032742,2,3,0
6,8,0,0,1,0.0,0,0,14,0,Spain,362,1.1552922511386405,0.2014957695955509,1,3,0
6,8,0,1,1,0.0,0,0,14,0,France,696,0.9273691142100396,0.502414742929987,1,3,0
17,4,0,6,8,100.0,0,0,21,0,UK,23,0.28764590440125637,2.2764687843498534,2,3,0
9,17,174,11,4,100.0,38,0,26,212,Italy,11,-1.6023036779031792,0.31687260755565083,0,0,1
5,11,2,1,1,0.0,0,1,16,2,France,132,-0.3386009863437443,-0.9120241313795616,3,0,2
15,9,2,1,1,0.0,0,0,24,2,France,330,-0.22454942415524357,-0.15953734222858457,3,0,2
5,8,37,6,3,100.0,1,0,13,38,Italy,13,-0.7932253199968405,0.31074625598274014,0,0,1
4,10,4,0,2,0.0,10,2,14,14,UK,32,-0.6658843078971146,-1.3532209143079255,3,0,1
4,8,0,0,1,0.0,0,0,12,0,France,675,1.3419139293825868,0.025257607180264242,1,3,0
10,8,85,2,2,50.0,0,2,18,85,UK,227,-0.8461707776381695,0.021460299968323847,0,0,1
6,8,0,0,1,0.0,0,0,14,0,Italy,615,1.1552922511386405,0.2014957695955509,1,3,0
3,8,0,0,1,0.0,0,0,11,0,France,504,1.8211872325051162,-0.5087243978983337,1,3,3
24,8,27,113,30,76.0,9,1,32,36,Italy,11,-1.5273446441143477,0.11697171885155076,0,0,1
7,8,1,0,1,0.0,3,0,15,4,France,604,0.059232413327572106,-1.061166548342134,3,0,2
7,8,1,1,1,0.0,0,0,15,1,Netherlands,230,0.19154399234241623,-0.2543581884614151,3,0,2
5,8,0,0,1,0.0,0,0,13,0,France,683,1.2296015562652716,0.13122512192593444,1,3,0
12,8,0,0,2,0.0,0,0,20,0,Sweden,12,0.6637085942019052,0.9430577206399774,1,3,0
10,8,0,7,6,100.0,0,0,18,0,France,31,0.08853967934114557,2.0404654498766845,2,3,0
6,9,4,2,1,0.0,11,0,15,15,Pologne,16,-0.4092381085791736,-0.9412986555060975,3,0,2
9,8,0,20,6,83.0,0,0,17,0,US,14,0.236030955461245,1.723520164801748,2,3,0
7,11,1,7,1,0.0,0,1,18,1,Netherlands,110,-0.4362576516620474,-0.7366922764354412,3,0,2
5,8,0,1,1,0.0,0,2,13,0,France,696,0.722664223856117,-0.07618661131074775,1,3,0
4,8,0,0,1,0.0,0,0,12,0,UK,693,1.3419139293825868,0.025257607180264242,1,3,0
4,8,0,2,1,0.0,0,0,12,0,France,45,1.1006727729320174,0.343759897484641,1,3,0
7,8,2,0,2,100.0,0,0,15,2,Netherlands,18,-0.1994996195834388,0.6596989284472355,2,0,1
11,8,0,0,7,28.0,0,0,19,0,France,279,0.4825187008438948,1.3688490298806169,2,3,0
5,8,1,8,3,100.0,0,0,13,1,France,43,-0.32589572093189945,0.9593672405966006,2,0,1
7,8,0,0,2,100.0,1,1,15,1,UK,186,-0.42379713323142254,0.14486799896908403,0,0,1
4,8,7,4,2,100.0,0,0,12,7,France,11,-0.2613438659108306,0.7054942464076891,2,0,1
5,8,3,0,1,0.0,14,0,13,17,France,73,0.11223392418948287,-1.2912454631358152,3,0,2
6,8,41,1,1,0.0,138,17,14,179,Germany,13,-0.6657399718567696,-1.697642958019777,3,0,2
10,8,0,0,2,100.0,0,0,18,0,UK,633,0.39643275215540963,1.6096760028790897,2,3,0
9,8,0,0,4,75.0,0,0,17,0,France,405,0.5461689132804567,1.3030574567073054,2,3,0
5,8,8,2,1,0.0,1,1,13,9,Sweden,46,-0.3591013886152255,-1.4046695393385178,3,0,2
9,8,1,2,4,0.0,0,1,17,1,France,31,-0.46797430584722494,-0.06291472060264258,0,0,1
8,9,3,0,1,0.0,0,0,17,3,France,23,0.13881190093883122,-0.624375854517009,3,0,2
6,9,1,0,2,100.0,0,0,15,1,France,218,-0.31948311563845067,0.5945504753330695,2,0,1
18,10,11,0,7,100.0,3,5,28,14,France,33,-1.423071999352017,-0.21135995723380102,0,0,1
6,8,1,0,1,0.0,0,0,14,1,France,386,0.4792107386002132,-0.6114953933053199,3,0,2
12,30,196,3,6,66.0,378,27,42,574,Netherlands,15,-2.0142489873757956,-0.6444720082353806,0,0,1
6,8,1,3,5,100.0,0,0,14,1,Spain,28,-0.3938426008171891,1.0323340151490044,2,0,1
7,8,64,0,2,100.0,0,0,15,64,France,84,-0.3544295436552475,0.47348528019968145,2,0,1
11,9,32,0,1,0.0,465,2,20,497,UK,17,-0.8289596668223762,-1.8780043800673596,3,0,2
6,8,0,0,1,0.0,0,0,14,0,Italy,202,1.1552922511386405,0.2014957695955509,1,3,0
5,8,0,0,1,0.0,0,0,13,0,Swiss,501,1.2296015562652716,0.13122512192593444,1,3,0
12,8,0,1,1,0.0,0,0,20,0,Spain,122,0.7083999974036674,0.7085848164636475,1,3,0
4,8,0,0,1,0.0,0,0,12,0,France,506,1.3419139293825868,0.025257607180264242,1,3,0
7,8,0,1,5,100.0,0,0,15,0,France,45,0.244423310238671,1.872592625108953,2,3,0
6,8,11,0,1,0.0,0,0,14,11,France,12,0.38178621665245815,-0.728545291417781,3,0,2
5,8,3,0,1,0.0,7,0,13,10,Italy,545,0.1391493499694732,-1.255432796717879,3,0,2
19,8,0,5,6,50.0,0,0,27,0,Italy,419,0.09918917443395506,1.8268087059064502,2,3,0
7,9,214,0,1,0.0,2,4,16,216,Sweden,11,-0.6512863851990428,-1.9070007113412613,3,0,2
6,8,0,0,2,100.0,0,0,14,0,France,14,0.5649709224492983,1.4508801831986478,2,3,0
4,8,0,1,3,100.0,0,0,12,0,Italy,11,0.508028109627456,1.6062792894600597,2,3,0
3,8,1,0,2,100.0,0,0,11,1,Italy,629,0.5547843912773469,-0.07233114719610702,2,0,3
6,8,0,0,2,0.0,0,0,14,0,France,216,0.8826777110082771,0.7368876471063168,1,3,0
4,8,0,0,1,0.0,0,0,12,0,Bahamas,590,1.3419139293825868,0.025257607180264242,1,3,0
10,9,23,2,2,0.0,11,0,19,34,Germany,183,-0.8852675175361199,-0.3349760386807541,0,0,2
3,8,0,0,2,100.0,0,0,11,0,France,424,1.230865903815774,0.7406600157047636,1,3,3
53,9,3,5,106,98.0,0,0,62,3,France,11,-1.139284684784916,1.3402664853136217,2,0,1
4,8,1,0,1,0.0,0,0,12,1,France,345,0.6658324168441594,-0.7877335557206065,3,0,2
5,8,0,1,1,0.0,0,0,13,0,US,534,1.0016784193366708,0.43214409526037056,1,3,0
8,8,38,3,9,77.0,1,3,16,39,Netherlands,12,-1.1328469008243727,-0.3235908194257785,0,0,1
5,11,8,1,4,75.0,3,0,16,11,Italy,16,-0.9352429643601543,-0.0023207876489943044,0,0,1
6,8,0,0,1,0.0,0,0,14,0,UK,616,1.1552922511386405,0.2014957695955509,1,3,0
12,11,6,8,3,100.0,5,2,23,11,Grèce,11,-1.6016997184183515,0.05663947723569285,0,0,1
9,8,89,0,2,100.0,3,21,17,92,US,76,-1.1124267147027513,-0.5379247966493087,0,0,1
6,8,2,4,3,0.0,0,0,14,2,France,13,-0.09487109600586167,0.2597529328424226,2,0,1
7,8,1,1,1,0.0,16,0,15,17,Germany,211,-0.22936530518328085,-0.8406433349588517,3,0,2
6,8,0,1,1,0.0,0,0,14,0,France,251,0.9273691142100396,0.502414742929987,1,3,0
7,8,1,0,1,0.0,1,0,15,2,Italy,120,0.08904359880234915,-1.0213913878844298,3,0,2
8,9,66,1,2,50.0,1,8,17,67,US,11,-1.2874971660998837,-0.5921456622839523,0,0,1
53,9,4,38,50,68.0,3,0,62,7,Spain,240,-1.4967394106488545,0.8079038912013561,0,0,1
11,8,1,2,3,100.0,0,0,19,1,France,12,-0.5634541607694065,1.1710654181129219,2,0,1
3,8,0,7,1,0.0,0,0,11,0,UK,83,1.551030425192834,-0.1520457816278505,1,3,3
25,26,876,7,5,100.0,15,12,51,891,France,11,-2.232144805064232,-0.16997358623909714,0,0,1
3,8,0,1,1,0.0,0,0,11,0,Îles Canaries,106,1.593264095576516,-0.20780542456389742,1,3,3
3,8,22,0,2,100.0,25,1,11,47,UK,303,-0.23265546333019718,-1.2653611052588751,3,0,3
10,10,7,1,3,100.0,8,1,20,15,UK,18,-1.484977158204965,-0.04014435957858517,0,0,1
4,8,0,0,1,0.0,0,0,12,0,France,34,1.3419139293825868,0.025257607180264242,1,3,0
11,8,33,0,3,100.0,4,1,19,37,UK,103,-1.0814573695752718,-0.29910740636901173,0,0,1
9,8,1,5,8,100.0,1,0,17,2,US,34,-0.8899249208509298,0.7404834105671799,2,0,1
22,11,432,3,9,70.0,181,37,33,613,Netherlands,12,-1.9201841274998175,-0.5839234774974558,0,0,1
5,8,1,0,1,0.0,0,0,13,1,UK,365,0.5535200437268443,-0.6817660409749363,3,0,2
47,8,4,9,63,98.0,1,0,55,5,Italy,12,-1.2629581136145587,0.8860397887452567,0,0,1
6,8,0,3,5,100.0,0,0,14,0,Italy,13,0.2822389117212382,1.8453251780498752,2,3,0
6,8,12,0,2,100.0,0,0,14,12,UK,73,-0.21271651577544415,0.5158092335363891,2,0,1
8,8,48,0,1,0.0,29,2,16,77,France,11,-0.45889191600342494,-1.766662816981661,3,0,2
3,8,0,0,1,0.0,0,0,11,0,UK,233,1.8211872325051162,-0.5087243978983337,1,3,3
3,8,2,0,1,0.0,0,0,11,2,France,291,1.1164602998015754,-1.356123884159215,3,0,3
4,8,0,0,1,0.0,0,0,12,0,France,696,1.3419139293825868,0.025257607180264242,1,3,0
5,8,0,0,1,0.0,0,0,13,0,France,581,1.2296015562652716,0.13122512192593444,1,3,0
8,8,0,2,3,100.0,0,0,16,0,France,341,0.20252571807107847,1.8995101046240035,2,3,0
5,8,1,1,1,0.0,0,0,13,1,Italy,224,0.3255969067982433,-0.38084706764050047,3,0,2
7,8,16,4,7,100.0,0,0,15,16,Germany,11,-0.585732788310836,0.978403417775504,2,0,1
4,8,1,0,1,0.0,0,0,12,1,Spain,157,0.6658324168441594,-0.7877335557206065,3,0,2
3,9,0,0,1,0.0,0,0,12,0,Italy,557,1.5244381286479023,-0.4789970662655853,1,3,3
4,8,13,13,5,100.0,0,0,12,13,France,16,-0.34719980739814565,0.7765085708239429,2,0,1
4,8,0,0,1,0.0,0,0,12,0,UK,372,1.3419139293825868,0.025257607180264242,1,3,0
10,8,4,5,7,71.0,2,0,18,6,Italy,71,-0.8278735849015473,0.35152733999262836,0,0,1
5,8,2,6,3,100.0,1,0,13,3,Monaco,11,-0.6714937796252504,0.4568858398205155,2,0,1
30,8,16,13,33,96.0,97,1,38,113,Germany,12,-1.6035536384263367,0.058857204091226946,0,0,1
6,8,1,0,1,0.0,0,0,14,1,US,239,0.4792107386002132,-0.6114953933053199,3,0,2
4,8,0,0,1,0.0,0,0,12,0,France,285,1.3419139293825868,0.025257607180264242,1,3,0
17,8,0,3,14,93.0,0,0,25,0,US,11,0.08861701045650848,1.8836201771215264,2,3,0
4,8,24,7,1,0.0,8,3,12,32,UK,13,-0.37977194834513195,-1.6160073351375923,3,0,2
10,8,0,2,3,0.0,0,0,18,0,Italy,11,0.4572570301266319,1.2449040524333974,2,3,0
4,8,1,2,2,0.0,0,0,12,1,France,117,0.15197672026322673,0.06616061209453575,3,0,1
4,8,3,2,8,87.0,120,7,12,123,UK,11,-0.8987338287490425,-0.7164690091526071,0,0,1
10,8,0,0,1,0.0,0,0,18,0,US,606,0.9867540808447519,0.36029158927599275,1,3,0
19,38,331,1,1,0.0,10,31,57,341,UK,11,-1.5384341165752784,-1.4938260265248204,0,0,2
5,9,5,0,2,100.0,0,0,14,5,Italy,20,-0.32053888128442537,0.452989821637173,2,0,1
9,19,38,1,3,100.0,1,0,28,39,France,59,-1.4150424841710167,0.4263548341552769,0,0,1
4,8,0,0,1,0.0,0,0,12,0,Italy,645,1.3419139293825868,0.025257607180264242,1,3,0
20,9,0,1,1,0.0,0,0,29,0,France,353,0.42546563746166716,0.7393703873834585,1,3,0
9,8,1,0,1,0.0,0,0,17,1,UK,679,0.33905476322170797,-0.47935802887534174,3,0,2
3,8,0,0,1,0.0,0,0,11,0,France,397,1.8211872325051162,-0.5087243978983337,1,3,3
3,8,0,1,3,0.0,0,0,11,0,France,497,1.305008201308965,0.35830474828913095,1,3,3
7,8,0,0,7,100.0,0,0,15,0,France,523,0.4628210773959801,1.5903806715959745,2,3,0
5,8,1,1,3,66.0,0,0,13,1,Pologne,125,-0.13046362333314143,0.5623757821933896,2,0,1
4,8,2,0,1,0.0,0,0,12,2,France,389,0.6371869966790458,-0.8221418790806172,3,0,2
3,8,55,0,1,0.0,21,3,11,76,Croatie,16,0.308451373855265,-2.5843052949238117,3,0,3
3,8,0,0,1,0.0,0,0,11,0,France,300,1.8211872325051162,-0.5087243978983337,1,3,3
6,8,0,0,7,85.0,0,0,14,0,France,30,0.6645625747902613,1.2150460854149587,2,3,0
4,8,3,0,1,0.0,1,0,12,4,Spain,509,0.298852439216974,-1.2974811411765401,3,0,2
6,8,55,4,3,100.0,0,0,14,55,France,12,-0.5601322743026969,0.7963597466377704,2,0,1
5,8,0,0,1,0.0,0,0,13,0,France,637,1.2296015562652716,0.13122512192593444,1,3,0
5,8,7,1,4,50.0,0,0,13,7,France,13,-0.21632579634800447,0.47777413573459127,2,0,1
5,8,0,0,1,0.0,0,0,13,0,France,397,1.2296015562652716,0.13122512192593444,1,3,0
7,8,0,0,1,0.0,0,0,15,0,France,578,1.0955486418094444,0.2577140011050198,1,3,0
5,8,6,0,3,33.0,0,0,13,6,France,359,0.029460943156327815,0.1616532718899438,2,0,1
7,9,102,8,9,100.0,222,28,16,324,Austria,11,-1.675268818773533,-0.3725359852273818,0,0,1
12,8,2,8,4,75.0,0,15,20,2,France,11,-0.8264699715867515,0.3156522449404187,0,0,1
5,8,0,4,1,0.0,0,0,13,0,France,11,0.9724210360918614,0.4707715985806595,1,3,0
13,8,12,3,16,81.0,1,0,21,13,Italy,40,-0.9461653730581268,0.43448271887846496,0,0,1
10,8,0,1,4,75.0,0,0,18,0,UK,497,0.28986358143647245,1.6306348852922041,2,3,0
50,8,0,44,64,93.0,0,0,58,0,Croatie,11,-0.26072527204755025,2.283401791954771,2,3,0
4,10,28,2,1,0.0,5,0,14,33,Italy,19,-0.40709179947379437,-1.1207428433733329,3,0,2
3,8,0,0,1,0.0,0,0,11,0,Italy,125,1.8211872325051162,-0.5087243978983337,1,3,3
3,8,11,0,2,50.0,0,0,11,11,UK,230,0.6109694796118993,-0.5345927913687535,3,0,3
6,8,14,2,3,0.0,10,0,14,24,Germany,24,-0.5246510402265496,-0.37365759257120845,3,0,1
6,8,0,0,1,0.0,0,0,14,0,France,336,1.1552922511386405,0.2014957695955509,1,3,0
3,8,0,0,1,0.0,0,0,11,0,France,506,1.8211872325051162,-0.5087243978983337,1,3,3
3,10,9,0,2,0.0,94,1,13,103,Italy,11,-0.35713384289112804,-1.9338091181359411,3,0,3
8,8,7,0,6,83.0,0,0,16,7,France,22,-0.1905869913424359,0.39322076036761283,2,0,1
3,8,2,1,1,0.0,0,0,11,2,Italy,118,0.8885371628729746,-1.0552049108247787,3,0,3
6,8,1,1,4,75.0,0,0,14,1,UK,262,-0.2176797608080663,0.6588479027108924,2,0,1
6,8,8,0,1,0.0,16,4,14,24,France,15,-0.2854809114343267,-1.7905502367823232,3,0,2
13,8,0,9,10,100.0,0,0,21,0,France,21,-0.004829967595104988,2.147253892939092,2,3,0
17,9,15,3,2,100.0,11,2,26,26,Spain,12,-1.5909130512042886,0.013666040458296887,0,0,1
3,8,0,0,1,0.0,0,0,11,0,Italy,26,1.8211872325051162,-0.5087243978983337,1,3,3
3,8,0,0,1,0.0,0,0,11,0,France,475,1.8211872325051162,-0.5087243978983337,1,3,3
13,9,19,18,3,100.0,0,0,22,19,Sweden,11,-0.956459421504026,1.0622163962290856,2,0,1
5,8,1,0,1,0.0,0,0,13,1,UK,692,0.5535200437268443,-0.6817660409749363,3,0,2
3,8,0,0,1,0.0,0,0,11,0,France,609,1.8211872325051162,-0.5087243978983337,1,3,3
10,9,70,5,10,90.0,1,0,19,71,Italy,12,-1.1473873482467232,0.19778158617087166,0,0,1
5,9,2,0,2,0.0,0,0,14,2,France,97,0.03440656068701109,-0.21628255937530655,3,0,2
6,9,8,0,1,0.0,0,0,15,8,France,60,0.18537298777217537,-0.7575141363611496,3,0,2
100,450,544,82,41,90.0,114,9,550,658,Italy,11,-2.6775862758388294,-0.03753674196938184,0,0,1
4,8,0,0,2,100.0,0,0,12,0,France,356,0.7515926006932446,1.2746420207833613,2,3,0
8,8,0,22,15,100.0,0,0,16,0,US,13,0.09292441704064731,2.0784611730337295,2,3,0
18,8,4,202,17,92.3,31,6,26,35,Swiss,11,-1.4909633412211876,0.02610596197741425,0,0,1
3,8,0,0,1,0.0,0,0,11,0,France,425,1.8211872325051162,-0.5087243978983337,1,3,3
6,8,0,25,6,66.0,2,0,14,2,Germany,12,-0.31034019329535045,0.6801873007754619,2,0,1
5,8,0,0,1,0.0,0,0,13,0,France,412,1.2296015562652716,0.13122512192593444,1,3,0
7,8,3,0,4,100.0,3,0,15,6,Netherlands,74,-0.5876057885567995,0.20161882030992523,2,0,1
8,8,3,0,3,0.0,0,0,16,3,France,336,0.04060037829861966,0.0002257766445458672,3,0,2
4,8,0,0,1,0.0,0,0,12,0,France,676,1.3419139293825868,0.025257607180264242,1,3,0
7,9,0,0,1,0.0,24,2,16,24,Italy,152,-0.163071242125787,-1.3346218270629524,3,0,2
5,8,1,0,2,100.0,5,1,13,6,Germany,25,-0.680907770837857,-0.44741797914154435,0,0,1
4,8,8,0,1,0.0,0,0,12,8,France,18,0.580367191565443,-0.8904137538117284,3,0,2
9,8,17,16,15,90.0,4,1,17,21,UK,12,-1.197794763194417,-0.14179447315163496,0,0,1
4,8,1,0,2,0.0,0,0,12,1,Swiss,251,0.39321787671379604,-0.252341678209841,3,0,2
4,8,76,1,1,0.0,25,5,12,101,Sweden,52,-0.42895752840829854,-1.792528975742625,3,0,2
14,8,2,0,4,75.0,0,0,22,2,UK,149,-0.2738258002863446,0.5642672660016411,2,0,1
5,8,2,0,4,25.0,0,0,13,2,Italy,260,0.0645639829782075,0.23379543284261714,2,0,1
6,8,0,12,11,83.0,1,1,14,1,US,11,-0.5613047967802701,0.25298252980057234,0,0,1
6,9,2,1,1,0.0,0,0,15,2,France,624,0.01426965595717695,-0.38832328829560225,3,0,2
4,8,30,1,3,100.0,0,0,12,30,Austria,11,-0.3130964422352475,0.6189379841894266,2,0,1
6,8,21,2,15,100.0,0,1,14,21,France,13,-0.8167354337891112,0.45028557117276397,2,0,1
3,8,1,4,1,0.0,0,0,11,1,Luxembourg,122,0.8879251997932786,-0.9821690841444793,3,0,3
8,8,2,5,6,50.0,0,0,16,2,UK,356,-0.39166208861630436,0.7779847254774347,2,0,1
3,8,1,0,1,0.0,0,0,11,1,US,288,1.1451057199666888,-1.3217155607992037,3,0,3
6,8,3,0,1,0.0,0,0,14,3,UK,100,0.4344189663566332,-0.6652937319871992,3,0,2
8,9,1,0,1,0.0,0,0,17,1,Netherlands,547,0.18360367318241116,-0.5705775158351302,3,0,2
4,8,2,1,1,0.0,0,0,12,2,France,330,0.4092638597504447,-0.5212229057461812,3,0,2
4,8,0,0,1,0.0,0,0,12,0,US,542,1.3419139293825868,0.025257607180264242,1,3,0
7,8,7,6,5,80.0,6,1,15,13,France,360,-1.0286255053935998,-0.3014725556102289,0,0,1
7,8,0,7,4,100.0,0,0,15,0,Italy,14,0.20953395496084384,1.913928654940306,2,3,0
3,8,7,2,1,0.0,8,0,11,15,France,88,0.45992017359505233,-1.6126240730285655,3,0,3
3,8,3,6,1,0.0,0,0,11,3,Italy,11,0.8341364923231915,-1.0240890828385878,3,0,3
3,9,6,0,1,0.0,0,2,12,6,Italy,11,0.4960849789844976,-1.88830404475961,3,0,3
6,8,11,2,2,0.0,4,5,14,15,Denmark,21,-0.7727465636770201,-0.9015359468960571,0,0,1
12,12,172,3,1,0.0,104,11,24,276,Denmark,11,-1.2510875194256683,-1.585532877879889,0,0,2
5,8,2,0,2,0.0,0,0,13,2,Germany,614,0.25226008343136735,-0.18078248682418122,3,0,2
3,8,19,0,1,0.0,0,0,11,19,France,22,1.0228553556892874,-1.4686481914360257,3,0,3
48,28,346,3,19,89.0,1075,54,76,1421,Italy,11,-2.323239648284576,-0.48179665684600065,0,0,1
40,8,0,12,37,94.0,0,0,48,0,Italy,11,-0.16210320024043356,2.163874959964246,2,3,0
11,8,3,1,11,63.0,2,0,19,5,Italy,129,-0.8223527539657691,0.3660054246125679,0,0,1
4,8,0,0,1,0.0,0,0,12,0,France,203,1.3419139293825868,0.025257607180264242,1,3,0
9,8,0,1,1,0.0,0,0,17,0,US,664,0.7872131388315343,0.6345521073599655,1,3,0
27,8,0,1,24,90.9,0,0,35,0,Italy,38,-0.005849207185863537,1.9781123779666656,2,3,0
3,9,30,0,1,0.0,1,1,12,31,Netherlands,13,0.11854297325900635,-2.4036513547367067,3,0,3
36,8,45,5,22,69.2,0,0,44,45,France,14,-0.9383968005855373,1.0452936135022652,2,0,1
12,8,26,2,4,60.0,0,2,20,26,France,21,-0.8618702008545688,0.19756544010978322,0,0,1
9,8,0,8,9,88.0,0,0,17,0,France,16,0.24160976783449525,1.7270271504861294,2,3,0
9,12,142,0,1,0.0,34,23,21,176,France,13,-0.9265824873659059,-1.951863966084863,3,0,2
3,8,0,1,1,0.0,0,0,11,0,France,27,1.593264095576516,-0.20780542456389742,1,3,3
5,8,0,0,1,0.0,0,0,13,0,UK,32,1.2296015562652716,0.13122512192593444,1,3,0
57,8,45,123,92,74.0,6,2,65,51,UK,11,-1.795419941544916,0.3530598136539505,0,0,1
16,10,263,3,23,86.0,5,1,26,268,Spain,15,-1.6898678129139284,-0.30107194124512177,0,0,1
5,8,90,3,6,0.0,0,1,13,90,France,11,-0.4785060643197753,-0.475349601809447,3,0,1
5,8,1,0,1,0.0,1,4,13,2,US,513,-0.06835112475792952,-1.678863228364264,3,0,2
4,8,1,0,1,0.0,0,0,12,1,France,31,0.6658324168441594,-0.7877335557206065,3,0,2
15,21,480,3,5,83.0,7,19,36,487,UK,11,-1.9040258573580289,-0.5400457901908733,0,0,1
3,9,0,1,1,0.0,0,0,12,0,US,333,1.2965149917193004,-0.1780780929311491,1,3,3
21,31,24,0,5,100.0,1,0,52,25,US,146,-1.403266142482938,0.3431006172187731,0,0,1
102,8,0,0,87,98.0,0,0,110,0,US,68,-0.06661341980289161,2.001661241584228,2,3,0
9,8,0,20,2,50.0,0,0,17,0,US,11,0.2838798393141589,1.6266829263209168,2,3,0
17,14,113,4,1,0.0,210,77,31,323,US,11,-1.4081657441179214,-1.6072276725185553,0,0,2
7,8,1,7,3,0.0,0,0,15,1,US,23,-0.13894557230881607,0.3675116273276601,2,0,1
3,9,55,1,1,0.0,1,0,12,56,France,23,0.12722989346110342,-1.6524133328392876,3,0,3
6,8,1,0,1,0.0,0,0,14,1,Germany,690,0.4792107386002132,-0.6114953933053199,3,0,2
10,8,183,3,3,66.0,11,3,18,194,Italy,11,-1.2830315545296116,-0.50068417032776,0,0,1
83,8,4,56,57,98.0,0,0,91,4,Taiwan,11,-1.071436172994569,1.4776292731716927,2,0,1
7,8,0,0,1,0.0,0,0,15,0,France,96,1.0955486418094444,0.2577140011050198,1,3,0
9,11,59,5,9,90.0,7,1,20,66,Netherlands,43,-1.5172382260949264,-0.36230600792734013,0,0,1
3,8,0,0,1,0.0,0,0,11,0,France,471,1.8211872325051162,-0.5087243978983337,1,3,3
12,8,3,8,12,84.0,1,0,20,4,UK,35,-0.8888490493477663,0.4945406473959142,0,0,1
3,8,0,1,1,0.0,0,0,11,0,Hong Kong,92,1.593264095576516,-0.20780542456389742,1,3,3
4,8,0,0,1,0.0,0,0,12,0,France,13,1.3419139293825868,0.025257607180264242,1,3,0
3,8,4,0,1,0.0,0,1,11,4,UK,67,0.8204064895146435,-1.8778417842874515,3,0,3
6,8,3,1,3,66.0,0,0,14,3,UK,53,-0.24956470070335254,0.5788480911811269,2,0,1
5,7,1,3,1,0.0,0,0,12,1,France,344,0.6504748930152763,-0.29073758071326644,3,0,2
7,8,0,0,1,0.0,0,0,15,0,Spain,474,1.0955486418094444,0.2577140011050198,1,3,0
4,8,0,0,1,0.0,0,0,12,0,UK,247,1.3419139293825868,0.025257607180264242,1,3,0
8,9,32,0,9,77.0,4,13,17,36,Finland,20,-1.1136650450983219,-0.7821649408661081,0,0,1
5,8,0,0,1,0.0,0,0,13,0,Italy,624,1.2296015562652716,0.13122512192593444,1,3,0
9,8,0,3,4,50.0,0,0,17,0,Italy,13,0.30303686173089506,1.617827183314975,2,3,0
33,2,9,1,14,85.0,5,0,35,14,US,15,-0.8071071870967607,0.6886697140736637,2,0,1
9,8,0,0,2,0.0,0,0,17,0,Netherlands,421,0.7425217356297718,0.8690250115362952,1,3,0
4,8,0,0,1,0.0,0,0,12,0,France,341,1.3419139293825868,0.025257607180264242,1,3,0
3,8,0,1,1,0.0,0,0,11,0,France,321,1.593264095576516,-0.20780542456389742,1,3,3
3,8,1,0,2,100.0,0,0,11,1,France,18,0.5547843912773469,-0.07233114719610702,2,0,3
10,8,8,1,11,72.0,0,0,18,8,France,358,-0.5024923421326222,0.775173773338426,2,0,1
4,8,0,0,1,0.0,0,0,12,0,France,372,1.3419139293825868,0.025257607180264242,1,3,0
5,9,3,0,2,100.0,1,0,14,4,France,115,-0.6216347853340394,0.02237071462110223,0,0,1
10,12,0,14,4,50.0,20,2,22,20,UK,151,-1.1351191527894833,0.09053678931010839,0,0,1
8,8,0,0,5,60.0,0,5,16,0,UK,11,0.28229137662568277,0.7343434759183801,2,3,0
4,9,53,2,2,100.0,1,0,13,54,France,433,-0.9019004636856712,0.10827034986164291,0,0,1
17,5,40,7,15,82.0,0,0,22,40,France,11,-0.455313121812743,0.9993412853271397,2,0,1
4,8,12,0,4,50.0,0,0,12,12,Singapour,130,0.10197822190383378,0.04451094902262346,2,0,1
3,8,0,0,1,0.0,0,0,11,0,UK,26,1.8211872325051162,-0.5087243978983337,1,3,3
9,8,1,1,1,0.0,0,0,17,1,US,631,0.11113162629310702,-0.17843905554090578,3,0,2
10,8,0,1,1,0.0,0,0,18,0,Spain,451,0.7588309439161511,0.661210562610429,1,3,0
20,8,7,1,15,43.0,0,0,28,7,UK,395,-0.6619187791261684,0.9402379570835145,2,0,1
17,11,2,0,5,80.0,2,3,28,4,Austria,45,-1.2158240709048524,-0.47329014727441227,0,0,1
4,8,0,0,1,0.0,0,0,12,0,France,322,1.3419139293825868,0.025257607180264242,1,3,0
3,8,0,0,1,0.0,0,0,11,0,Portugal,24,1.8211872325051162,-0.5087243978983337,1,3,3
8,10,116,7,3,0.0,23,0,18,139,Italy,70,-1.0334135549920942,-0.44286115299761186,0,0,2
7,8,17,1,5,80.0,0,0,15,17,Romania,59,-0.4047530112950312,0.5925650252793684,2,0,1
5,10,65,3,1,0.0,1,1,15,66,Italy,14,-0.7733634385664042,-1.533146260378729,3,0,2
5,10,0,0,1,0.0,0,0,15,0,France,50,0.9210406923879927,0.1080364477103952,1,3,0
3,8,1,2,1,0.0,0,0,11,1,UK,462,0.9038645635161199,-1.0032132704948276,3,0,3
4,8,1,0,1,0.0,0,0,12,1,Italy,629,0.6658324168441594,-0.7877335557206065,3,0,2
7,11,38,0,1,0.0,3,2,18,41,France,37,-0.6706409769533888,-1.7789689501159018,3,0,2
5,10,0,6,11,100.0,0,0,15,0,Italy,11,0.007150418713094967,1.8215577047895548,2,3,0
8,8,0,0,1,0.0,0,0,16,0,Bulgaria,601,1.0497295573481775,0.3009051053742676,1,3,0
12,22,74,0,1,0.0,278,4,34,352,France,16,-1.1270701180062843,-1.8630935848048622,0,0,2
3,8,0,0,1,0.0,0,0,11,0,US,670,1.8211872325051162,-0.5087243978983337,1,3,3
4,9,19,3,1,0.0,1,2,13,20,UK,18,-0.5480211843842789,-1.5765650616073525,3,0,2
3,8,0,0,1,0.0,0,0,11,0,France,681,1.8211872325051162,-0.5087243978983337,1,3,3
16,8,0,2,4,100.0,1,0,24,1,France,31,-0.6485686475783503,1.2137929085886983,2,0,1
5,8,0,0,2,0.0,0,0,13,0,Germany,203,0.9569870161349087,0.6666169994367005,1,3,0
4,9,4,0,2,0.0,0,0,13,4,France,22,0.09111917742557075,-0.33389197128127507,3,0,2
3,8,32,0,1,0.0,0,0,11,32,France,577,0.9966863208054381,-1.5001109533613173,3,0,3
3,8,0,0,1,0.0,0,0,11,0,Italy,659,1.8211872325051162,-0.5087243978983337,1,3,3
6,8,7,0,2,100.0,15,2,14,22,Netherlands,160,-0.857483522454996,-0.5112409810328932,0,0,1
31,8,0,5,9,88.0,0,0,39,0,Italy,68,-0.04607664143098654,1.9932196888208438,2,3,0
8,11,549,5,1,0.0,8,10,19,557,Germany,11,-1.1599617717079382,-1.6552374442231979,0,0,2
5,8,4,0,1,0.0,0,0,13,4,UK,33,0.4964576349158233,-0.7502897809590349,3,0,2
4,8,9,1,1,0.0,113,5,12,122,France,14,-0.4041095818709678,-1.7691648904742887,3,0,2
7,8,0,1,10,60.0,0,0,15,0,France,13,0.37525871758572427,1.5726179946681589,2,3,0
3,9,0,0,1,0.0,0,0,12,0,France,688,1.5244381286479023,-0.4789970662655853,1,3,3
6,8,0,0,3,66.0,0,0,14,0,Belgium,230,0.6992317210072554,1.1447186194294412,2,3,0
6,8,0,0,1,0.0,0,0,14,0,UK,634,1.1552922511386405,0.2014957695955509,1,3,0
11,8,0,0,2,100.0,0,0,19,0,France,169,0.36950986235677746,1.6348359953671545,2,3,0
7,8,0,0,1,0.0,0,0,15,0,US,665,1.0955486418094444,0.2577140011050198,1,3,0
8,10,22,0,1,0.0,0,0,18,22,France,149,-0.015377835923388553,-0.7333791233103975,3,0,2
6,8,1,1,2,100.0,0,0,14,1,France,373,-0.33903372701773,0.9388079936322133,2,0,1
16,8,0,25,9,100.0,0,0,24,0,US,131,-0.07236330328015984,2.216705293479669,2,3,0
5,8,12,0,1,0.0,0,0,13,12,Netherlands,36,0.4519141180405295,-0.8038458277363244,3,0,2
6,9,33,0,1,0.0,3,2,15,36,UK,49,-0.4938603935779388,-1.8190261134240633,3,0,2
7,8,0,0,2,100.0,0,0,15,0,US,167,0.5052273131201024,1.5070984147081177,2,3,0
5,8,0,6,6,100.0,0,0,13,0,UK,19,0.33536650667402995,1.8061451828986383,2,3,0
3,8,0,0,1,0.0,0,0,11,0,France,528,1.8211872325051162,-0.5087243978983337,1,3,3
5,9,2,0,1,0.0,0,0,14,2,UK,505,0.3070211008173742,-0.7516744368860725,3,0,2
10,8,7,3,2,100.0,1,0,18,8,Sweden,26,-0.9287295165947872,0.5781522467088739,0,0,1
3,8,128,0,1,0.0,0,5,11,128,Denmark,39,0.6255807077090778,-2.129637316216353,3,0,3
3,8,0,0,1,0.0,0,0,11,0,France,650,1.8211872325051162,-0.5087243978983337,1,3,3
15,9,4,0,1,0.0,0,7,24,4,Australia,79,-0.32713071792991794,-1.0449391520339821,3,0,2
4,8,9,6,2,0.0,2,0,12,11,Belgium,133,-0.2934448376931516,-0.4771039149617175,3,0,1
53,61,1160,62,45,80.0,4,69,114,1164,US,11,-2.4378544749236783,-0.2225515280535927,0,0,1
8,10,16,0,3,0.0,134,10,18,150,UK,12,-1.0508703322963149,-1.3443422399606564,0,0,1
10,8,16,0,1,0.0,0,0,18,16,Germany,13,0.19538073531134628,-0.5912321411992024,3,0,2
13,10,0,0,1,0.0,0,0,23,0,France,196,0.6797528745455493,0.34402878999043146,1,3,0
3,8,0,1,2,0.0,14,0,11,14,France,66,0.5622560726264169,-0.6747918997435319,3,0,3
4,8,0,0,1,0.0,0,0,12,0,US,352,1.3419139293825868,0.025257607180264242,1,3,0
5,8,0,0,1,0.0,1,0,13,1,France,191,0.568213931554771,-0.7434028103089484,3,0,1
3,8,0,1,2,0.0,0,0,11,0,Italy,19,1.3206495554461528,0.3275864529468685,1,3,3
5,8,0,0,1,0.0,0,0,13,0,France,223,1.2296015562652716,0.13122512192593444,1,3,0
9,8,9,0,1,0.0,1113,66,17,1122,Spain,12,-0.6857308940786584,-2.028276754016365,3,0,2
10,8,0,0,1,0.0,0,0,18,0,Spain,578,0.9867540808447519,0.36029158927599275,1,3,0
14,9,1,5,4,0.0,0,0,23,1,France,327,-0.5132810848652622,0.49146658120675196,2,0,1
11,8,1,1,1,0.0,1,0,19,2,Spain,584,-0.27459698888957634,-0.5927348338909565,3,0,2
26,44,1,0,9,53.0,0,0,70,1,France,210,-0.8973714619035339,0.6922614451751898,0,0,1
3,8,0,0,3,0.0,0,0,11,0,UK,34,1.5329313382375653,0.05738577495469483,1,3,3
4,8,8,3,2,100.0,0,0,12,8,Italy,130,-0.2598052818991286,0.6888404175761962,2,0,1
43,16,31,0,3,100.0,2,2,59,33,US,12,-1.704560244109128,-0.1227462701060709,0,0,1
34,9,46,25,27,96.0,0,0,43,46,France,12,-1.1579932089846972,1.052191349620259,0,0,1
13,10,4,0,1,0.0,2,2,23,6,Sweden,550,-0.6670685192847324,-1.5190450744572712,3,0,2
23,8,2,1,1,0.0,1916,405,31,1918,Belgium,29,-1.3708485029598807,-1.9097411596229281,0,0,2
9,8,338,6,1,0.0,224,14,17,562,US,11,-0.9446786521228637,-1.6350018221306106,3,0,2
3,8,27,0,1,0.0,2,2,11,29,UK,17,0.3982703033518516,-2.463123579662126,3,0,3
4,10,32,50,4,75.0,0,0,14,32,Italy,11,-0.6129532041108721,0.4278525082221686,2,0,1
17,9,70,4,7,42.0,1,0,26,71,US,11,-1.232321329946925,0.24507544586624833,0,0,1
3,8,3,3,1,0.0,1,0,11,4,Belgium,14,0.5282745975642742,-1.5015933884703099,3,0,3
23,22,28,23,60,96.4,139,6,45,167,UK,11,-2.03086466411014,-0.14343183092667391,0,0,1
125,500,7044,117,67,90.0,664,0,625,7708,Sweden,16,-2.8623349918944108,0.033539154041798726,0,0,1
4,8,0,0,1,0.0,0,0,12,0,UK,693,1.3419139293825868,0.025257607180264242,1,3,0
4,8,0,2,1,0.0,0,1,12,0,US,19,0.8330359512909928,-0.14384258601950858,1,3,0
18,9,1,2,6,83.0,0,0,27,1,France,12,-0.729059603720172,0.9268935019406058,2,0,1
23,8,2,0,11,100.0,0,0,31,2,US,186,-0.5574899084405328,1.055563195379584,2,0,1
17,9,71,6,4,0.0,120,3,26,191,Swiss,15,-1.454600542106217,-0.8096394300953453,0,0,1
4,8,0,1,1,0.0,0,0,12,0,Spain,640,1.1139907924539858,0.3261765805147003,1,3,0
74,161,151,7,13,92.0,23,0,235,174,Italy,12,-2.0743436131976343,0.4761491607228178,0,0,1
7,9,1,0,1,0.0,0,1,16,1,UK,471,-0.04644977762886331,-1.0945621769968186,3,0,2
4,8,2,0,2,0.0,1,0,12,3,Italy,12,0.04034419158814895,-0.7452173230022437,3,0,2
5,9,19,1,2,100.0,1,4,14,20,Germany,44,-1.2139775531470116,-0.2952896919023975,0,0,1
3,8,32,5,2,100.0,1,0,11,33,UK,13,-0.17325357464431232,-0.35457229611954544,3,0,3
23,35,5,4,7,100.0,4,0,58,9,US,15,-1.663318816689628,0.7610676223600912,0,0,1
3,8,0,3,2,0.0,0,0,11,0,US,135,1.2987215475995235,0.3565372373972601,1,3,3
7,8,3,3,6,50.0,0,2,15,3,UK,47,-0.6286379671373626,0.1907470490060019,2,0,1
9,17,56,4,2,100.0,3,4,26,59,Belgium,21,-1.7318624882713478,-0.1516467744262394,0,0,1
8,8,0,0,3,66.0,0,0,16,0,France,584,0.5936690272167927,1.2441279552081574,2,3,0
16,22,20,0,2,100.0,14,2,38,34,US,33,-1.60179435642193,-0.3456855966296155,0,0,1
8,8,41,1,2,100.0,50,1,16,91,Belgium,15,-1.274072655559218,-0.2075358669861266,0,0,1
4,8,1,0,1,0.0,0,0,12,1,France,516,0.6658324168441594,-0.7877335557206065,3,0,2
3,8,0,0,1,0.0,1,0,11,1,Germany,263,1.159799607794616,-1.3833523301332167,3,0,3
4,8,2,1,1,0.0,0,3,12,2,France,17,0.1232211217228193,-1.0423587815774678,3,0,2
4,8,0,1,4,100.0,0,0,12,0,France,45,0.4981329129176678,1.6257126180795043,2,3,0
18,8,8,0,3,66.0,0,0,26,8,Spain,13,-0.370922165108455,0.5197947572324584,2,0,1
4,8,5,0,1,0.0,5,1,12,10,Italy,362,-0.021915637797741482,-1.8544441447226938,3,0,2
19,10,14,54,12,83.3,108,20,29,122,Spain,22,-1.7730747147400177,-0.2722121867296813,0,0,1
12,8,90,4,6,33.0,0,0,20,90,Spain,244,-0.6740228046684779,0.6636645708017649,2,0,1
8,8,367,14,2,50.0,1,19,16,368,Romania,11,-1.2721867750910194,-0.6061218071148814,0,0,1
4,8,0,2,2,100.0,0,0,12,0,France,15,0.5103514442426749,1.5931443110877381,2,3,0
11,8,1,2,4,100.0,0,0,19,1,Germany,64,-0.5733493574791948,1.1904987467323664,2,0,1
5,8,0,0,1,0.0,0,0,13,0,France,366,1.2296015562652716,0.13122512192593444,1,3,0
4,8,0,0,1,0.0,0,0,12,0,France,260,1.3419139293825868,0.025257607180264242,1,3,0
3,8,5,0,1,0.0,0,4,11,5,Germany,48,0.7877740083730124,-1.9318270005398162,3,0,3
3,9,10,1,2,100.0,79,2,12,89,Bulgaria,12,-0.7831039298800393,-0.9773895660366987,0,0,3
4,8,0,0,1,0.0,0,0,12,0,France,418,1.3419139293825868,0.025257607180264242,1,3,0
4,8,0,0,2,0.0,0,0,12,0,Belgium,573,1.0692993892522236,0.5606494846910302,1,3,0
6,8,0,0,4,75.0,3,0,14,3,Belgium,227,-0.013109246611378291,0.24635202027021572,2,0,1
7,8,13,0,2,100.0,3,4,15,16,Germany,192,-0.9050327005277344,-0.4411504156777716,0,0,1
13,21,8,0,1,0.0,9,0,34,17,Spain,689,-0.6361161317408995,-1.0663268071002672,3,0,2
4,8,0,0,2,50.0,0,0,12,0,France,103,0.9052022109755518,0.9294302747231765,1,3,0
3,8,4,3,1,0.0,2,0,11,6,UK,13,0.5035288893801592,-1.5335977979900899,3,0,3
12,8,0,0,7,100.0,0,0,20,0,UK,251,0.30359556991880393,1.7403325136201655,2,3,0
11,8,1,4,9,50.0,0,0,19,1,Spain,17,-0.4602596314905686,0.9146052484585814,2,0,1
4,8,0,4,4,60.0,0,0,12,0,France,32,0.6206838709442656,1.3231764242815593,2,3,0
8,10,176,8,7,100.0,28,1,18,204,France,11,-1.6773077317088811,-0.19438276038089852,0,0,1
4,8,1,1,1,0.0,1,0,12,2,Sweden,83,0.10748574944689053,-0.9529288084747495,3,0,2
3,8,0,1,1,0.0,0,0,11,0,US,297,1.593264095576516,-0.20780542456389742,1,3,3
28,8,83,34,51,100.0,25,8,36,108,UK,12,-1.8112899505307638,0.30698653839469797,0,0,1
5,8,0,1,1,0.0,0,0,13,0,France,16,1.0016784193366708,0.43214409526037056,1,3,0
4,8,0,0,2,100.0,0,0,12,0,France,659,0.7515926006932446,1.2746420207833613,2,3,0
4,8,0,1,2,0.0,0,0,12,0,Italy,223,0.8413762523236227,0.8615684580254663,1,3,0
5,8,0,0,1,0.0,0,0,13,0,France,456,1.2296015562652716,0.13122512192593444,1,3,0
12,10,2,1,1,0.0,0,0,22,2,UK,455,-0.23567669089679158,-0.2192240510554031,3,0,2
6,4,0,1,2,100.0,0,0,10,0,France,260,1.0752976362297746,1.5198148904817592,2,3,2
4,8,0,0,2,100.0,0,0,12,0,Belgium,51,0.7515926006932446,1.2746420207833613,2,3,0
7,8,1,0,1,0.0,0,0,15,1,Monaco,91,0.4194671292710171,-0.5552771617958512,3,0,2
4,8,0,5,7,100.0,0,0,12,0,UK,18,0.44696963561719777,1.704119885765244,2,3,0
8,14,2,3,1,0.0,12,3,22,14,Italy,11,-0.9728704365436376,-1.3374010866068125,0,0,2
18,9,4,9,18,100.0,3,1,27,7,France,15,-1.6118711353506472,0.3237403494613944,0,0,1
7,11,19,1,2,0.0,1,1,18,20,France,13,-1.1065904919041791,-0.8544040458738417,0,0,1
9,12,5,2,2,0.0,1,0,21,6,Italy,22,-0.8900930591179821,-0.2218839581782331,0,0,2
7,8,1,2,4,100.0,0,0,15,1,France,12,-0.4376319067158702,1.0627611660733294,2,0,1
11,8,0,11,3,66.0,0,0,19,0,Spain,17,0.22254819109211793,1.6999626563827177,2,3,0
3,8,0,0,1,0.0,0,0,11,0,UK,12,1.8211872325051162,-0.5087243978983337,1,3,3
5,8,2,0,2,100.0,0,0,13,2,Italy,363,-0.06544670512761169,0.5332100492681502,2,0,1
4,8,0,1,1,0.0,0,0,12,0,France,339,1.1139907924539858,0.3261765805147003,1,3,0
4,8,3,0,1,0.0,0,5,12,3,Germany,292,0.32499631724884986,-1.380889477409636,3,0,2
3,8,0,1,1,0.0,0,0,11,0,Italy,205,1.593264095576516,-0.20780542456389742,1,3,3
58,48,593,39,47,93.0,66,1,106,659,Spain,11,-2.3433294254434682,-0.07449351764060402,0,0,1
4,8,1,0,1,0.0,7,0,12,8,US,629,0.2777961167706672,-1.3303841786231883,3,0,2
4,8,6,5,6,83.0,1,0,12,7,France,120,-0.47389017778386006,0.018623862280759428,2,0,1
10,8,0,0,2,66.0,0,0,18,0,UK,132,0.5463349048505544,1.2727961437676198,2,3,0
5,8,2,4,4,100.0,0,0,13,2,UK,11,-0.3481637761479978,0.922908149884581,2,0,1
4,8,37,1,5,60.0,0,0,12,37,France,17,-0.1906243867842903,0.29708597822367716,2,0,1
3,8,0,0,1,0.0,0,0,11,0,France,416,1.8211872325051162,-0.5087243978983337,1,3,3
10,9,20,5,6,33.0,1,8,19,21,Denmark,15,-1.357687081156533,-0.350163766505767,0,0,1
5,11,0,0,1,0.0,5,0,16,5,Germany,359,0.1438290417345136,-0.8267540963084908,3,0,2
167,8,0,25,125,100.0,0,0,175,0,US,22,-0.6182207728964421,2.8348482442054848,2,3,0
3,8,1,2,1,0.0,0,0,11,1,UK,71,0.9038645635161199,-1.0032132704948276,3,0,3
6,11,6,13,6,57.0,1,9,17,7,France,11,-1.3212418677960744,-0.3856366419991322,0,0,1
10,8,21,18,16,100.0,1,0,18,22,Italy,11,-1.0862939699764382,0.7149485157800941,0,0,1
3,8,0,0,1,0.0,0,0,11,0,Italy,604,1.8211872325051162,-0.5087243978983337,1,3,3
5,8,0,9,14,100.0,0,0,13,0,Italy,13,0.2964690863399345,1.8759959246429276,2,3,0
33,8,563,1,1,0.0,410,9,41,973,France,11,-1.25746553822989,-1.4372551588772517,0,0,2
5,8,3,0,1,0.0,6,2,13,9,Germany,59,-0.13584176576946333,-1.7583379286055676,3,0,2
38,14,166,7,9,77.0,16,6,52,182,Grèce,11,-1.9686570625380384,-0.2514390493365286,0,0,1
4,10,0,0,1,0.0,0,0,14,0,UK,132,0.9966893005774249,0.03238092484209717,1,3,0
25,8,5,0,2,100.0,2,0,33,7,US,205,-0.8912696222510071,0.44537298145017984,0,0,1
5,8,7,0,2,100.0,0,0,13,7,Italy,589,-0.11647571885473534,0.47191528449863457,2,0,1
3,8,0,0,1,0.0,0,0,11,0,Belgium,471,1.8211872325051162,-0.5087243978983337,1,3,3
16,8,9,0,2,100.0,17,0,24,26,France,519,-0.8754220881690447,0.25159338967177225,0,0,1
22,8,0,0,1,0.0,0,0,30,0,Germany,664,0.806306092768126,0.5302975016732612,1,3,0
16,21,85,2,3,25.0,4,2,37,89,Germany,324,-1.727736669717537,-0.39287932361750055,0,0,1
13,8,3,4,1,0.0,0,0,21,3,Italy,11,-0.06236961509512958,-0.09997863727010228,3,0,2
7,9,55,1,1,0.0,13,5,16,68,France,15,-0.8411733923138494,-1.5702006244319937,3,0,2
13,8,0,0,1,0.0,0,0,21,0,UK,269,0.9156841898602878,0.4272643876579227,1,3,0
8,8,18,0,1,0.0,0,4,16,18,US,14,-0.037634260156088895,-1.1870787730671513,3,0,2
7,8,1,0,1,0.0,0,0,15,1,France,310,0.4194671292710171,-0.5552771617958512,3,0,2
3,8,0,1,3,66.0,0,3,11,0,France,76,0.8511608274175053,0.21428154943870623,1,3,3
9,8,0,0,2,50.0,0,0,17,0,Germany,511,0.5784245573531005,1.2378058015684406,2,3,0
4,8,5,1,1,0.0,0,0,12,5,France,13,0.3720252063379874,-0.5659430608260333,3,0,2
3,9,103,0,1,0.0,3,1,12,106,France,13,0.03728329444538991,-2.504762877746073,3,0,3
3,8,88,2,1,0.0,0,1,11,88,France,18,0.4343626063350891,-1.7333634808812053,3,0,3
4,20,1,0,1,0.0,0,0,24,1,US,376,0.018742925030105422,-0.6608086147398576,3,0,2
5,8,1,0,2,0.0,0,1,13,1,France,45,0.013268681955456682,-0.6339766469683202,3,0,1
7,8,1,1,1,0.0,1,0,15,2,France,583,-0.13887953812625173,-0.7204724145499939,3,0,2
6,8,0,0,1,0.0,0,0,14,0,Sweden,683,1.1552922511386405,0.2014957695955509,1,3,0
3,8,0,1,1,0.0,0,1,11,0,Germany,57,1.3256272739354913,-0.6954079080680469,1,3,3
4,8,0,0,1,0.0,0,0,12,0,France,272,1.3419139293825868,0.025257607180264242,1,3,0
5,10,14,0,1,0.0,0,3,15,14,US,123,-0.1494301619303268,-1.3562608580050406,3,0,2
33,11,459,11,6,83.0,56,65,44,515,Spain,11,-2.0193470850930177,-0.45374272691933304,0,0,1
18,9,1,5,3,100.0,0,0,27,1,France,11,-0.8714372571881078,1.2336796226518714,2,0,1
4,0,7,1,1,0.0,94,1,4,101,UK,11,0.8094619779032733,-1.723902861264964,3,1,2
4,8,0,0,1,0.0,0,0,12,0,France,173,1.3419139293825868,0.025257607180264242,1,3,0
6,8,1,1,2,0.0,0,0,14,1,Romania,12,-0.021326938458750992,0.22481545753988172,2,0,1
4,8,7,0,2,100.0,0,0,12,7,Italy,241,-0.004163345737420206,0.36594776975296417,2,0,1
8,8,44,0,1,0.0,14,0,16,58,Italy,13,-0.1586527723213254,-1.2300306044857086,3,0,2
8,8,8,0,2,100.0,0,0,16,8,Spain,14,-0.30213850915830814,0.6346181579853721,2,0,1
11,8,5,0,1,0.0,0,0,19,5,Russia,625,0.21786560493012141,-0.5066680595766763,3,0,2
10,8,55,12,1,0.0,0,0,18,55,US,627,-0.148884016820426,-0.29038754546801726,3,0,2
6,8,2,0,3,0.0,3,0,14,5,France,521,-0.1883416810909768,-0.5738537428809273,3,0,2
13,9,0,1,2,0.0,1,0,22,1,Italy,470,-0.42313736474586744,0.3195855603400774,0,0,1
7,8,0,37,30,90.0,0,0,15,0,UK,13,0.2450678529099468,1.7796341615252782,2,3,0
29,8,2,13,26,100.0,0,0,37,2,UK,11,-0.927330449801065,1.5385896614422847,2,0,1
8,14,3,0,1,0.0,11,0,22,14,Italy,80,-0.4427672494775694,-1.1522792442180232,3,0,2
17,8,40,3,23,95.0,0,7,25,40,France,11,-1.0655108366499264,0.3555834499614302,0,0,1
5,8,0,0,4,50.0,0,0,13,0,Italy,145,0.7673532870112607,1.0855494134305523,2,3,0
111,37,237,7,35,91.0,2,1,148,239,France,11,-2.2322909493104377,0.07701420621953056,0,0,1
5,8,5,2,1,0.0,5,1,13,10,Hong Kong,13,-0.3754691673656261,-1.429974339672647,3,0,2
4,8,3,12,6,83.0,0,0,12,3,Germany,39,-0.14687673288315006,0.5335840854351125,2,0,1
3,8,0,0,1,0.0,0,0,11,0,Italy,140,1.8211872325051162,-0.5087243978983337,1,3,3
3,8,0,0,1,0.0,0,0,11,0,Denmark,93,1.8211872325051162,-0.5087243978983337,1,3,3
5,9,21,11,3,0.0,0,0,14,21,Italy,11,-0.36170787673813143,0.06641182303222072,3,0,1
14,10,295,1,4,50.0,0,0,24,295,Denmark,11,-0.9724621164997655,0.4756485348016956,0,0,1
4,8,0,2,1,0.0,0,0,12,0,Spain,168,1.1006727729320174,0.343759897484641,1,3,0
8,8,0,0,3,100.0,0,3,16,0,France,20,0.15772413649402242,1.0598719384883408,2,3,0
6,8,1,4,7,100.0,0,0,14,1,France,12,-0.41069734598666174,1.060717753840359,2,0,1
17,8,2,0,12,83.0,0,0,25,2,UK,418,-0.35397277013553885,0.6803035092627105,2,0,1
9,8,0,0,1,0.0,0,0,17,0,Spain,653,1.0151362757601352,0.3336331340255293,1,3,0
7,9,14,3,1,0.0,4,1,16,18,Spain,43,-0.7483227182812171,-1.3812079912311073,3,0,2
12,22,46,0,1,0.0,12,2,34,58,Pologne,12,-0.9930635714507731,-1.6806828850088784,0,0,2
7,9,8,1,6,83.0,29,0,16,37,Italy,20,-0.9857336054017207,0.01898137534595093,0,0,1
7,8,97,3,3,100.0,4,0,15,101,Belgium,40,-0.9827338708976053,0.32492198902530717,0,0,1
3,8,1,1,1,0.0,0,0,11,1,France,130,0.9171825830380881,-1.0207965874647678,3,0,3
9,13,103,4,6,83.0,201,0,22,304,Spain,14,-1.4059072309971699,-0.06899435611840296,0,0,1
21,16,5979,1,6,100.0,634,40,37,6613,Hong Kong,62,-2.3071194341614247,-0.5531996540121531,0,0,1
12,12,8,2,2,0.0,0,0,24,8,UK,15,-0.6445280557404404,0.2620377274926755,0,0,1
3,8,0,0,1,0.0,0,0,11,0,UK,334,1.8211872325051162,-0.5087243978983337,1,3,3
7,8,4,31,21,100.0,0,0,15,4,France,11,-0.6118289676699129,1.1826679061047884,2,0,1
8,8,2,12,16,100.0,0,0,16,2,Italy,13,-0.5989580025508495,1.215025032200791,2,0,1
6,8,3,0,1,0.0,0,0,14,3,France,664,0.4344189663566332,-0.6652937319871992,3,0,2
8,10,87,1,1,0.0,5,2,18,92,Netherlands,120,-0.9362134297773159,-1.5120721778194115,0,0,2
8,8,0,0,1,0.0,0,0,16,0,Italy,288,1.0497295573481775,0.3009051053742676,1,3,0
8,8,0,0,1,0.0,0,0,16,0,France,686,1.0497295573481775,0.3009051053742676,1,3,0
8,8,2,0,1,0.0,0,0,16,2,UK,26,0.3450026246446366,-0.546494380886614,3,0,2
8,8,0,0,2,0.0,0,0,16,0,France,586,0.7771150172178146,0.8362969828850336,1,3,0
4,8,0,0,1,0.0,0,0,12,0,France,470,1.3419139293825868,0.025257607180264242,1,3,0
6,11,0,2,6,100.0,0,0,17,0,France,38,-0.054112999722085005,1.8113356615978329,2,3,0
4,8,1,1,2,100.0,0,0,12,1,France,12,-0.15241204877378373,0.7625698312169268,2,0,1
4,8,0,2,1,0.0,0,0,12,0,France,363,1.1006727729320174,0.343759897484641,1,3,0
5,10,1,0,2,100.0,1,0,15,2,France,72,-0.675785679308445,0.07831547232404262,0,0,1
6,9,241,0,1,0.0,30,4,15,271,Germany,11,-0.6573769894970457,-2.0320512602477896,3,0,2
6,8,0,0,2,100.0,0,0,14,0,US,371,0.5649709224492983,1.4508801831986478,2,3,0
6,8,1,6,1,0.0,0,0,14,1,France,318,0.21303328320029533,-0.2600705766628246,3,0,2
16,10,153,0,3,100.0,2,6,26,155,Germany,13,-1.5024433210112964,-0.4398684557040956,0,0,1
5,10,2,0,1,0.0,0,0,15,2,France,30,0.21631375968445157,-0.7393630385504865,3,0,2
5,9,0,0,2,100.0,0,0,14,0,Italy,16,0.4214267048315731,1.3451094629779061,2,3,0
14,8,31,17,24,83.0,1,0,22,32,Germany,15,-1.0589259339482462,0.47463809945661123,0,0,1
3,8,1,0,1,0.0,0,0,11,1,France,655,1.1451057199666888,-1.3217155607992037,3,0,3
5,8,0,0,1,0.0,0,0,13,0,France,607,1.2296015562652716,0.13122512192593444,1,3,0
10,9,53,1,12,91.0,160,7,19,213,Sweden,11,-1.5307862975334128,-0.5297232931462695,0,0,1
20,8,203,13,22,100.0,19,5,28,222,UK,14,-1.7206629548807622,0.1145110327639761,0,0,1
7,8,10,1,9,100.0,0,0,15,10,France,89,-0.5420207804107473,0.9815912937401521,2,0,1
16,8,0,14,10,100.0,0,0,24,0,US,523,-0.060968698635521304,2.2040665401372164,2,3,0
17,8,23,2,11,63.0,45,12,25,68,Hong Kong,11,-1.4033663669950596,-0.2863728833006456,0,0,1
3,8,0,0,2,0.0,0,0,11,0,France,45,1.5485726923747536,0.02666747961243265,1,3,3
3,8,0,0,1,0.0,0,0,11,0,France,423,1.8211872325051162,-0.5087243978983337,1,3,3
17,15,9,1,2,100.0,0,0,32,9,Italy,15,-1.0664173328575441,1.0197007062165333,0,0,1
4,8,0,0,1,0.0,0,0,12,0,UK,548,1.3419139293825868,0.025257607180264242,1,3,0
5,8,8,0,2,0.0,1,5,13,9,Spain,13,-0.4188822780057244,-1.2395350516351291,3,0,1
7,8,23,2,6,83.0,1,0,15,24,Italy,11,-0.7561878172051535,0.15499048140339597,0,0,1
3,8,5,3,6,100.0,0,0,11,5,France,11,0.20131290742256466,0.25252096287596915,2,0,3
3,8,257,0,1,0.0,0,0,11,257,France,12,0.8814187363721274,-1.6386976862751887,3,0,3
6,8,0,0,1,0.0,0,0,14,0,France,610,1.1552922511386405,0.2014957695955509,1,3,0
3,8,0,0,1,0.0,0,0,11,0,France,513,1.8211872325051162,-0.5087243978983337,1,3,3
5,8,0,0,2,0.0,0,0,13,0,UK,11,0.9569870161349087,0.6666169994367005,1,3,0
7,9,6,6,8,100.0,0,0,16,6,UK,131,-0.7545872772842248,0.996240071564866,2,0,1
10,8,3,26,10,0.0,155,30,18,158,France,11,-1.1883212859281604,-0.750194222331476,0,0,1
13,8,2,0,4,100.0,0,0,21,2,Belgium,34,-0.40490062237957075,0.8794009389618446,2,0,1
10,10,156,1,2,100.0,1,1,20,157,Spain,15,-1.576639157931159,-0.19247931863292528,0,0,1
13,8,3,16,28,96.0,0,0,21,3,Romania,11,-0.6356107786361144,1.0574121909968186,2,0,1
13,10,46,7,12,100.0,0,0,23,46,UK,11,-1.086151508145676,1.0544227181967283,2,0,1
25,1,0,32,28,89.0,0,0,26,0,Spain,12,0.30005584965889626,2.178895746129517,2,3,0
21,8,61,5,9,66.0,170,1,29,231,Italy,56,-1.503061510467959,-0.2585170291959302,0,0,1
4,10,9,0,1,0.0,17,3,14,26,France,235,-0.4443722100489411,-1.9569284878749151,3,0,2
8,8,0,9,1,0.0,9,2,16,9,US,39,-0.24489398940075252,-0.81956936446716,3,0,2
5,8,8,0,1,0.0,1,0,13,9,France,69,0.14977658947636838,-1.235569346138744,3,0,2
5,8,1,2,4,80.0,0,0,13,1,France,23,-0.15878940908799746,0.61088206732212,2,0,1
4,8,0,0,1,0.0,0,0,12,0,Italy,591,1.3419139293825868,0.025257607180264242,1,3,0
4,8,0,0,1,0.0,0,0,12,0,UK,210,1.3419139293825868,0.025257607180264242,1,3,0
10,8,0,2,1,0.0,0,0,18,0,Spain,626,0.7455129243941823,0.6787938795803692,1,3,0
6,10,45,2,1,0.0,1,3,16,46,France,45,-0.8209591869809375,-1.5036542387423146,3,0,2
5,8,0,0,1,0.0,0,0,13,0,France,638,1.2296015562652716,0.13122512192593444,1,3,0
9,10,27,2,2,100.0,6,1,19,33,France,13,-1.5024485935689633,-0.12879667140285145,0,0,1
123,8,1,117,86,100.0,0,0,131,1,US,55,-1.2439199529143103,1.9650752512104523,2,0,1
73,27,104,8,69,98.0,182,115,100,286,France,11,-2.3314620246171973,-0.1829469616356858,0,0,1
6,8,32,0,4,75.0,23,0,14,55,Austria,174,-0.5202882667551606,-0.35989481905275633,3,0,1
20,22,4,0,6,66.0,235,25,42,239,France,219,-1.6403694330446685,-0.7670663574696319,0,0,1
7,11,4,0,1,0.0,15,1,18,19,UK,590,-0.6182181705310642,-1.7160884938638261,3,0,2
3,9,24,0,1,0.0,4,1,12,28,France,83,0.10533503221247867,-2.4241600770136804,3,0,3
3,8,1,1,1,0.0,0,0,11,1,UK,11,0.9171825830380881,-1.0207965874647678,3,0,3
11,8,0,4,1,0.0,0,0,19,0,US,560,0.7026506708727094,0.7249980584187818,1,3,0
6,13,36,0,2,0.0,2,0,19,38,US,346,-0.6893344736296202,-0.7430148075363804,0,0,2
20,8,0,4,2,100.0,0,0,28,0,Belgium,181,-0.021332605666112375,2.1001467998528245,2,3,0
8,8,1,0,2,100.0,0,0,16,1,Germany,81,-0.21667328387959192,0.7372983560764942,2,0,1
3,8,0,0,2,100.0,0,0,11,0,France,585,1.230865903815774,0.7406600157047636,1,3,3
4,8,4,0,1,0.0,0,0,12,4,France,107,0.6087700080331384,-0.8562572957047054,3,0,2
12,8,2,1,1,0.0,0,0,20,2,Germany,17,0.0036730647001264665,-0.13881466979723386,3,0,2
3,8,0,1,3,0.0,0,0,11,0,France,96,1.305008201308965,0.35830474828913095,1,3,3
6,8,1,2,3,66.0,0,3,14,1,UK,40,-0.5041336860093666,0.12909387100166017,2,0,1
16,8,0,2,3,100.0,0,0,24,0,UK,21,0.022714173841938357,2.0689875122041372,2,3,0
7,8,0,3,3,100.0,0,0,15,0,US,423,0.23973481420768528,1.867686467835206,2,3,0
9,8,0,3,2,100.0,0,0,17,0,US,47,0.17496380229556352,1.9128873054134534,2,3,0
31,28,57,2,6,50.0,0,0,59,57,France,226,-1.2627628158276323,0.7799672076829399,0,0,1
11,9,18,11,6,85.0,18,0,20,36,France,11,-1.168924151487345,0.19912657522333516,0,0,1
36,41,89,35,23,86.0,128,1,77,217,Hong Kong,11,-2.1635078399053214,-0.10733678510628876,0,0,1
5,8,0,1,2,0.0,0,0,13,0,France,152,0.7290638792063077,0.9675359727711366,1,3,0
9,8,2,3,1,0.0,0,0,17,2,US,73,0.060558198281364696,-0.18389659445052492,3,0,2
11,8,0,0,4,0.0,0,0,19,0,France,96,0.6616801000687809,0.9709950832365293,1,3,0
5,0,0,0,1,0.0,0,0,5,0,UK,621,2.438735218284601,0.07649590508851463,1,1,2
5,8,1,3,4,100.0,4,1,13,5,US,22,-0.949373397056898,-0.05824271016293419,0,0,1
21,8,0,23,13,84.0,0,0,29,0,US,11,0.004834602424269675,1.9707855405341714,2,3,0
7,8,112,0,1,0.0,61,2,15,173,Germany,25,-0.4691296929537039,-1.87935251098376,3,0,2
18,9,180,5,2,100.0,58,18,27,238,Netherlands,13,-1.8119965296100256,-0.22777400594873207,0,0,1
4,8,0,1,1,0.0,0,0,12,0,Belgium,382,1.1139907924539858,0.3261765805147003,1,3,0
3,8,0,1,2,100.0,0,0,11,0,France,183,1.0029427668871735,1.0415789890391995,2,3,3
5,8,8,9,1,0.0,0,0,13,8,Germany,11,0.19171578955926163,-0.41960545113182546,3,0,2
3,8,1,0,3,100.0,2,5,11,3,Germany,260,-0.10537601710737605,-1.0712463596217439,3,0,3
3,8,0,0,1,0.0,0,0,11,0,UK,147,1.8211872325051162,-0.5087243978983337,1,3,3
7,8,0,0,3,66.0,0,0,15,0,Monaco,125,0.6394881116780596,1.2009368509389096,2,3,0
7,16,82,0,1,0.0,44,16,23,126,France,18,-0.9271407515034368,-1.9365506847500535,3,0,2
39,17,474,66,41,87.0,17,0,56,491,Chypre,11,-1.8687417770594692,0.4012891390388881,0,0,1
3,8,0,0,1,0.0,0,0,11,0,Swiss,687,1.8211872325051162,-0.5087243978983337,1,3,3
5,8,2,0,1,0.0,0,0,13,2,Netherlands,356,0.5248746235617306,-0.7161743643349473,3,0,2
3,8,0,4,5,80.0,0,0,11,0,France,17,1.0855941008615788,0.8193915098537646,1,3,3
6,9,14,1,1,0.0,34,12,15,48,France,259,-0.7841340100426959,-1.6235554852939027,3,0,2
4,8,0,6,4,100.0,1,8,12,1,France,16,-0.5061641354312578,0.24654513225677885,0,0,1
9,8,0,1,4,100.0,0,0,17,0,Italy,29,0.1713552592952164,1.9340881449247695,2,3,0
7,8,2,8,9,66.0,0,0,15,2,France,39,-0.373167620138324,0.7822753273597011,2,0,1
13,8,0,1,7,85.0,0,0,21,0,Italy,109,0.19703137658330802,1.7417336768117664,2,3,0
5,8,1,0,1,0.0,0,0,13,1,France,568,0.5535200437268443,-0.6817660409749363,3,0,2
4,8,11,9,1,0.0,4,2,12,15,UK,40,-0.33157808586983173,-1.5358006127562216,3,0,2
7,8,4,0,15,53.0,0,0,15,4,Italy,78,-0.14428652118481217,0.4181255145609264,2,0,1
12,8,15,8,4,75.0,6,0,20,21,France,11,-0.9459883649922844,0.2930714553790089,0,0,1
11,11,385,3,8,100.0,39,3,22,424,Italy,13,-1.8362784304553381,-0.23937283895615813,0,0,1
9,9,0,0,4,25.0,0,0,18,0,Spain,26,0.3686284578663654,1.2219307814647649,2,3,0
10,8,4,5,3,100.0,1,0,18,5,Italy,70,-0.9354091724668991,0.650789964819487,0,0,1
6,8,2,0,2,100.0,0,0,14,2,France,377,-0.13975601025424286,0.6034806969377665,2,0,1
7,8,0,0,1,0.0,0,0,15,0,UK,158,1.0955486418094444,0.2577140011050198,1,3,0
32,8,1,4,19,100.0,0,0,40,1,Italy,11,-0.8909954996650724,1.5460283712886411,2,0,1
5,8,22,1,1,0.0,0,0,13,22,France,47,0.19514739058629157,-0.5376264686777331,3,0,2
6,8,13,0,1,0.0,3,1,14,16,France,13,-0.2311569461341149,-1.7033725829937374,3,0,2
13,8,0,0,4,75.0,0,0,21,0,UK,98,0.44671682738060964,1.3966887103396994,2,3,0
6,8,30,2,1,0.0,6,0,14,36,Italy,21,-0.25551377610030057,-0.9606601535690596,3,0,2
6,8,221,42,5,100.0,1,0,14,222,Italy,13,-1.0294149891621907,0.3577019523458174,0,0,1
4,8,40,0,2,100.0,9,4,12,49,France,165,-0.7319156357598,-0.765533617477622,0,0,1
5,9,5,5,3,0.0,1,0,14,6,Italy,17,-0.6006906019644851,-0.33733765015978595,0,0,2
3,8,3,2,1,0.0,4,2,11,7,UK,19,0.22547454926836705,-2.065152575495614,3,0,3
4,8,4,1,1,0.0,11,0,12,15,UK,20,-0.0009258852639370817,-1.091781589926617,3,0,2
11,9,14,3,24,87.0,0,0,20,14,Italy,14,-0.7886602817609264,0.8019207468906229,2,0,1
8,8,36,0,4,50.0,2,0,16,38,France,101,-0.5727185824785688,-0.21044549235925122,0,0,1
18,19,17,0,2,0.0,1,0,37,18,Spain,16,-0.926141886598121,-0.45820591508747427,0,0,2
13,9,0,10,3,66.0,186,15,22,186,Spain,14,-1.1837697782306054,-0.056988002691611354,0,0,1
30,8,2,4,1,0.0,0,0,38,2,France,382,-0.23652744976331735,0.09775371245392178,3,0,2
4,8,2,0,1,0.0,0,0,12,2,US,466,0.6371869966790458,-0.8221418790806172,3,0,2
3,8,2,0,1,0.0,0,0,11,2,UK,18,1.1164602998015754,-1.356123884159215,3,0,3
39,77,29,2,13,76.0,0,0,116,29,Italy,36,-1.4008938133674729,0.9363867781502336,0,0,1
8,9,4,3,5,60.0,0,3,17,4,UK,24,-0.8807464718022302,0.14242857968557512,0,0,1
3,8,44,0,2,0.0,2,0,11,46,France,14,0.378875004121624,-1.4503853693462438,3,0,3
6,8,0,1,1,0.0,0,0,14,0,France,46,0.9273691142100396,0.502414742929987,1,3,0
8,8,0,0,1,0.0,1,1,16,1,Spain,646,0.12070511099665268,-1.061325310364765,3,0,2
7,19,0,0,1,0.0,16,0,26,16,France,181,-0.15453329141482475,-0.7536046445208766,3,0,2
47,56,1,23,21,85.0,0,0,103,1,Romania,11,-1.3254357609280776,1.2409754748538568,0,0,1
4,9,17,0,1,0.0,7,4,13,24,France,24,-0.34344169310398426,-1.9751464479555587,3,0,2
4,11,0,0,3,0.0,7,0,15,7,Spain,174,-0.09088256867885172,-0.34372179044494544,3,0,1
6,9,87,3,1,0.0,5,3,15,92,Germany,15,-0.8094034474086881,-1.5741607786260505,3,0,2
22,9,0,4,8,87.0,0,0,31,0,Netherlands,15,-0.12056312923575989,1.821383634992524,2,3,0
3,8,0,0,1,0.0,0,0,11,0,UK,177,1.8211872325051162,-0.5087243978983337,1,3,3
5,13,2,0,1,0.0,103,6,18,105,Germany,17,-0.698761300210307,-1.9133680861930402,3,0,2
7,8,3,0,1,0.0,0,0,15,3,Romania,425,0.37467535702743726,-0.6090755004777301,3,0,2
6,10,0,0,1,0.0,0,1,16,0,UK,688,0.5986680031058372,-0.3254778472698304,1,3,0
3,8,0,0,1,0.0,2,1,11,2,France,319,0.867916324218319,-1.9027634169657226,3,0,3
7,8,0,0,1,0.0,0,0,15,0,UK,397,1.0955486418094444,0.2577140011050198,1,3,0
7,9,1,0,1,0.0,0,0,16,1,Germany,472,0.22118704401216102,-0.6069596934926688,3,0,2
5,8,3,0,2,0.0,1,0,13,4,Denmark,57,-0.08607447403070423,-0.6561217489201039,3,0,2
41,9,16,8,6,100.0,3,0,50,19,Germany,15,-1.5330588502127718,0.8438750320055679,0,0,1
8,18,122,3,1,0.0,33,0,26,155,Grèce,11,-0.9272051224163974,-1.0121414500556898,0,0,2
5,11,9,1,2,100.0,10,0,16,19,France,17,-1.0916302119949772,0.2309825081784381,0,0,1
3,8,0,2,3,66.0,0,0,11,0,Denmark,42,1.1238855459231623,0.7530007422399336,1,3,3
26,8,11,1,5,60.0,0,0,34,11,Italy,14,-0.7081238948675361,0.9130755809293059,2,0,1
6,9,31,0,1,0.0,0,1,15,31,Italy,16,-0.14338538938577836,-1.3186400670604752,3,0,2
3,8,0,0,1,0.0,0,0,11,0,France,272,1.8211872325051162,-0.5087243978983337,1,3,3
5,10,0,0,1,0.0,0,0,15,0,Italy,292,0.9210406923879927,0.1080364477103952,1,3,0
6,8,13,0,7,57.0,2,1,14,15,Spain,13,-0.7037741356780834,-0.702167713046523,0,0,1
29,8,29,0,2,0.0,0,0,37,29,France,17,-0.3544439544217117,0.14636862166234552,3,0,1
4,8,0,0,1,0.0,0,0,12,0,US,586,1.3419139293825868,0.025257607180264242,1,3,0
31,8,6,0,1,0.0,0,0,39,6,France,318,-0.03312544016848619,-0.2863156350305104,3,0,2
9,8,1,1,12,91.0,5,0,17,6,UK,358,-0.7786110560291654,0.3530824052982645,0,0,1
40,8,0,1,14,78.0,0,0,48,0,France,282,-0.06762362162866313,2.0113888926576013,2,3,0
5,8,4,0,1,0.0,0,0,13,4,US,397,0.4964576349158233,-0.7502897809590349,3,0,2
7,9,1,2,1,0.0,0,0,16,1,Swiss,644,-0.02005411243840838,-0.2884574031882921,3,0,2
10,9,3,0,1,0.0,1,1,19,4,US,47,-0.5094206575910022,-1.5123176773567817,3,0,2
10,10,9,0,4,75.0,4,0,20,13,Canada,103,-0.8435406459588463,-0.15090270818373322,0,0,1
3,8,0,1,1,0.0,0,0,11,0,France,172,1.593264095576516,-0.20780542456389742,1,3,3
7,8,0,6,2,100.0,0,0,15,0,Sweden,33,0.23904985772018447,1.8585232313506115,2,3,0
3,8,1,2,2,0.0,0,0,11,1,Italy,338,0.6312500233857565,-0.46782139298406167,3,0,3
6,8,5,0,1,0.0,30,4,14,35,France,125,-0.29616034991759954,-1.8062615096341403,3,0,2
34,8,3,3,11,90.0,3,0,42,6,Sweden,14,-1.1280282565121222,0.6557489279185632,0,0,1
14,13,94,3,3,66.0,44,10,27,138,US,11,-1.7034943404410001,-0.546915275143561,0,0,1
6,8,3,4,2,100.0,0,0,14,3,Italy,12,-0.41308288250611946,0.9236371582706232,2,0,1
13,10,1,3,13,76.0,0,5,23,1,France,11,-1.0504965210178234,0.3684257668367111,0,0,1
33,8,3,3,3,0.0,0,0,41,3,UK,121,-0.5555346072268106,0.6559983866643309,2,0,1
10,9,23,2,3,66.0,3,0,19,26,US,65,-1.0400062171829294,0.1122579221834753,0,0,1
30,0,6,1,2,100.0,9,10,30,15,Netherlands,17,-0.7340622608756399,0.46597548617172924,2,2,2
7,8,157,3,1,0.0,1,6,15,158,UK,11,-0.6818936959401439,-1.5031431988139596,3,0,2
5,8,1,11,6,100.0,0,0,13,1,France,11,-0.35576002028709647,1.0130174281400424,2,0,1
4,8,20,0,2,100.0,6,7,12,26,Germany,131,-0.7019323035361479,-0.7346198804638635,0,0,1
31,9,0,0,1,0.0,0,0,40,0,UK,367,0.5443046234074526,0.5411755587397333,1,3,0
7,8,0,0,1,0.0,0,0,15,0,UK,708,1.0955486418094444,0.2577140011050198,1,3,0
4,8,4,0,1,0.0,0,0,12,4,Italy,33,0.6087700080331384,-0.8562572957047054,3,0,2
27,9,55,2,5,100.0,0,0,36,55,Serbie,16,-1.1330844736347012,1.1117671894854417,2,0,1
5,8,0,0,1,0.0,0,0,13,0,France,246,1.2296015562652716,0.13122512192593444,1,3,0
5,8,0,0,1,0.0,0,0,13,0,Germany,600,1.2296015562652716,0.13122512192593444,1,3,0
14,8,22,6,13,61.0,2,2,22,24,Netherlands,25,-1.283498883822558,-0.11606519872201358,0,0,1
3,8,0,0,2,0.0,0,0,11,0,Italy,666,1.5485726923747536,0.02666747961243265,1,3,3
34,16,35,28,24,84.0,1,0,50,36,Italy,11,-1.6014104163167104,0.5584754240640247,0,0,1
6,9,12,1,1,0.0,1,0,15,13,France,80,-0.3766736698056958,-0.9267532315570596,3,0,2
9,8,1,19,12,91.0,0,0,17,1,Spain,14,-0.46690267475931085,0.9660183381813194,2,0,1
15,8,0,21,11,100.0,0,0,23,0,France,11,-0.05916155457935965,2.209587551526137,2,3,0
167,8,2,19,170,99.0,0,0,175,2,Monaco,12,-1.215733589758185,1.7445244247792258,2,0,1
4,8,0,0,1,0.0,0,0,12,0,France,12,1.3419139293825868,0.025257607180264242,1,3,0
6,8,6,1,2,100.0,5,1,14,11,UK,375,-1.0330572240405707,-0.135404040604668,0,0,1
10,8,0,17,4,100.0,0,0,18,0,US,23,0.08116938130820146,2.0423438487425343,2,3,0
20,8,1,2,9,77.0,0,0,28,1,Italy,180,-0.5858702198795516,1.0370523519393389,2,0,1
5,9,12,0,2,0.0,1,0,14,13,France,20,-0.3565367650758619,-0.754712502636764,3,0,2
6,8,0,0,1,0.0,0,0,14,0,Italy,602,1.1552922511386405,0.2014957695955509,1,3,0
12,8,0,0,10,100.0,0,0,20,0,France,71,0.2921480057657416,1.7628145604761487,2,3,0
30,8,79,0,1,0.0,3,0,38,82,Japon,11,-0.47979150841648766,-0.9153350545309474,3,0,2
5,8,0,0,1,0.0,0,0,13,0,France,138,1.2296015562652716,0.13122512192593444,1,3,0
4,8,3,0,1,0.0,0,0,12,3,France,481,0.6210406446005794,-0.8415318944024855,3,0,2
5,8,138,1,2,100.0,54,6,13,192,Belgium,14,-1.1829041877109339,-0.5035137192736742,0,0,1
4,8,0,0,1,0.0,0,0,12,0,UK,509,1.3419139293825868,0.025257607180264242,1,3,0
4,7,0,0,1,0.0,0,0,11,0,France,71,1.7404327368262589,0.04366242493702356,1,3,2
23,8,4,2,2,100.0,0,0,31,4,Netherlands,11,-0.7697565639513719,1.2272380422263052,2,0,1
12,8,11,0,13,92.0,2,2,20,13,Italy,13,-0.9632817063225713,-0.4327380955754468,0,0,1
30,8,0,6,7,83.3,0,0,38,0,France,13,-0.03064062765358232,1.9685895927683028,2,3,0
5,9,77,2,3,66.0,3,6,14,80,Hong Kong,11,-1.1891551424525497,-0.7080096892164135,0,0,1
5,8,0,0,2,100.0,0,0,13,0,France,75,0.6392802275759294,1.3806095355290318,2,3,0
19,14,175,0,4,0.0,107,5,33,282,Denmark,201,-1.4063207429073037,-1.2241561345854206,0,0,1
9,8,0,0,1,0.0,0,0,17,0,Romania,83,1.0151362757601352,0.3336331340255293,1,3,0
9,8,2,10,12,84.0,0,0,17,2,Belgium,11,-0.4769332164773597,0.9027546507349525,2,0,1
19,13,56,0,3,100.0,3,11,32,59,Germany,12,-1.5787973052940714,-0.3809389074680819,0,0,1
9,9,4,0,1,0.0,0,1,18,4,Luxembourg,309,-0.1718416445405842,-1.0971564021019184,3,0,2
16,8,1,4,15,100.0,757,31,24,758,Germany,42,-1.658133684609394,-0.04832987695222423,0,0,1
3,8,0,0,1,0.0,0,0,11,0,Austria,118,1.8211872325051162,-0.5087243978983337,1,3,3
25,10,7,0,1,0.0,0,1,35,7,Italy,12,-0.47603133089392774,-0.9268638427445965,3,0,2
5,8,0,6,4,100.0,0,0,13,0,Spain,13,0.3475662213290358,1.782185976133233,2,3,0
4,8,1,0,1,0.0,0,0,12,1,France,174,0.6658324168441594,-0.7877335557206065,3,0,2
4,8,6,2,2,100.0,1,0,12,7,Italy,15,-0.5586753313118982,0.23930505207046512,2,0,1
5,8,0,0,1,0.0,6,1,13,6,France,603,0.23789070060015685,-1.313344326620004,3,0,2
13,8,0,15,10,100.0,3,0,21,3,France,14,-0.7153592869915294,1.2373344058065545,2,0,1
6,9,0,0,1,0.0,0,4,15,0,Germany,508,0.6554720875732128,-0.3728257366699058,1,3,0
26,9,27,2,2,100.0,6,3,35,33,Sweden,28,-1.68983585470551,0.06877588627382678,0,0,1
6,9,2,4,17,76.0,0,0,15,2,Italy,18,-0.5311090869954626,0.7125948509716461,2,0,1
65,157,792,2,3,0.0,707,18,222,1499,Ukraine,11,-2.29192751422683,-0.904663920053591,0,0,1
28,8,0,0,1,0.0,0,0,36,0,France,620,0.7468681622483125,0.5858059299598103,1,3,0
30,9,21,1,1,0.0,0,0,39,21,UK,76,-0.477847469424501,-0.13415226243767261,3,0,2
4,8,0,0,2,50.0,0,0,12,0,France,315,0.9052022109755518,0.9294302747231765,1,3,0
8,8,24,1,7,100.0,0,0,16,24,France,28,-0.6214440817304876,0.9599035592841308,2,0,1
8,8,3,0,2,100.0,0,1,16,3,UK,33,-0.5291018777641963,0.19589753389046538,2,0,1
13,9,52,0,7,85.0,1,4,22,53,France,46,-1.2095318648731286,-0.6300965138188442,0,0,1
3,8,0,0,1,0.0,0,0,11,0,UK,395,1.8211872325051162,-0.5087243978983337,1,3,3
5,8,2,0,1,0.0,0,0,13,2,Italy,660,0.5248746235617306,-0.7161743643349473,3,0,2
6,8,5,0,1,0.0,0,0,14,5,US,690,0.413326665022642,-0.6906238717451826,3,0,2
30,8,0,4,3,100.0,0,0,38,0,Italy,80,-0.13776319988630586,2.225255907660163,2,3,0
6,8,0,1,1,0.0,0,0,14,0,UK,18,0.9273691142100396,0.502414742929987,1,3,0
3,8,1,0,1,0.0,0,0,11,1,Italy,628,1.1451057199666888,-1.3217155607992037,3,0,3
6,8,0,1,1,0.0,0,1,14,0,Austria,116,0.6597322925690152,0.01481225942583759,1,3,0
57,11,26,55,31,100.0,3,0,68,29,Bulgaria,11,-1.8069539235541467,1.02452494551624,0,0,1
6,8,0,9,8,100.0,0,1,14,0,US,24,-0.025023023643295405,1.4184941314627093,2,3,0
4,8,2,1,3,100.0,0,0,12,2,France,19,-0.19669882307608483,0.7588798031991784,2,0,1
6,8,0,3,1,0.0,0,0,14,0,Spain,11,0.9054411063634108,0.5313655273803783,1,3,0
5,8,1,0,1,0.0,0,0,13,1,Italy,13,0.5535200437268443,-0.6817660409749363,3,0,2
30,8,7,6,48,35.0,0,0,38,7,Bulgaria,43,-0.8344588260388403,1.1508449977817665,2,0,1
11,10,0,1,2,100.0,1,0,21,1,Portugal,22,-0.7646258550238995,0.9852443104126147,2,0,1
33,9,6,0,5,80.0,0,0,42,6,France,15,-0.6945466729685922,0.6395369542909922,2,0,1
3,8,5,1,1,0.0,1,0,11,6,France,11,0.5312980837105906,-1.5531739050455462,3,0,3
7,10,11,2,1,0.0,0,0,17,11,US,15,-0.1898578215971036,-0.40834881630898645,3,0,2
21,9,0,1,4,50.0,0,1,30,0,France,119,-0.31414435600097096,1.2155069831995275,2,3,0
3,8,7,0,1,0.0,1,0,11,8,Swiss,13,0.7458761085301493,-1.8701179118533762,3,0,3
4,8,0,0,2,0.0,0,0,12,0,UK,127,1.0692993892522236,0.5606494846910302,1,3,0
28,9,15,1,2,100.0,0,1,37,15,UK,126,-1.2999800761660885,0.6289107310980226,0,0,1
7,8,5,4,4,100.0,0,0,15,5,France,17,-0.5194553440162821,1.0046768739838148,2,0,1
31,0,17,0,1,0.0,0,0,31,17,France,125,0.7060126833752733,-0.04302987870151061,3,2,2
7,8,6,0,4,100.0,2,1,15,8,UK,266,-0.8703509439333783,-0.30258534401602283,0,0,1
3,9,0,0,1,0.0,0,0,12,0,Italy,323,1.5244381286479023,-0.4789970662655853,1,3,3
9,10,62,8,9,100.0,10,1,19,72,France,15,-1.6349490561143554,-0.04995021121022832,0,0,1
11,8,0,6,13,92.0,1,0,19,1,Sweden,71,-0.48446241346941304,0.9281281230541294,2,0,1
5,9,13,0,1,0.0,24,5,14,37,France,43,-0.46132899426642093,-1.939435290741888,3,0,2
17,10,81,20,20,100.0,80,9,27,161,Austria,11,-1.9186901160517125,0.0022412498834191476,0,0,1
8,9,29,25,20,92.8,0,1,17,29,Netherlands,14,-1.0583955966617231,0.26115157761372426,0,0,1
4,8,0,0,1,0.0,0,0,12,0,France,694,1.3419139293825868,0.025257607180264242,1,3,0
3,8,0,1,1,0.0,0,0,11,0,France,244,1.593264095576516,-0.20780542456389742,1,3,3
11,8,9,0,2,0.0,6,1,19,15,Spain,26,-0.7009351559334291,-0.9885803162035707,0,0,1
31,10,521,3,2,0.0,159,17,41,680,Portugal,11,-1.7375235993539386,-0.9525532935428901,0,0,1
3,8,2,0,2,0.0,4,0,11,6,UK,84,0.48472126955878275,-1.3261466007342648,3,0,3
21,9,3,20,27,85.0,0,0,30,3,Italy,11,-0.9058468739445626,1.0686655325732597,2,0,1
3,8,0,1,1,0.0,0,0,11,0,France,133,1.593264095576516,-0.20780542456389742,1,3,3
31,7,14,3,1,0.0,9,1,38,23,Grèce,17,-0.6756790937919689,-0.8767738836919404,3,0,2
54,8,5,102,63,98.0,3,0,62,8,US,293,-1.3803729231232065,0.9486421954926568,0,0,1
5,8,0,0,1,0.0,0,0,13,0,UK,706,1.2296015562652716,0.13122512192593444,1,3,0
3,8,3,0,1,0.0,8,2,11,11,France,191,0.44707850608692234,-2.4098353399179357,3,0,3
11,9,1,0,1,0.0,0,0,20,1,Italy,684,0.10137822552634373,-0.4923746718609007,3,0,2
107,3649,310,217,70,98.0,0,0,3756,310,France,11,-2.7977908332299015,1.4324089816372114,0,0,1
