socialNbFollowers,socialNbFollows,socialProductsLiked,productsListed,productsSold,productsPassRate,productsWished,productsBought,social,products,country,daysSinceLastLogin,x,y,kmeans,spectral,aggl
31,8,0,1,1,0.0,0,1,39,0,France,127,0.22065355544473914,0.4279771267226589,3,3,0
7,8,6,1,1,0.0,0,0,15,6,France,485,0.11828655069799371,-0.342343297483454,2,0,2
10,8,0,0,3,66.0,0,0,18,0,UK,665,0.530693550713367,1.303514439109881,0,3,0
3,8,0,0,1,0.0,0,0,11,0,France,405,1.8211872325051166,-0.5087243978983329,3,3,3
16,0,6,0,1,0.0,303,32,16,309,UK,20,0.12392511510043325,-1.514337724207306,2,2,2
8,8,0,4,3,100.0,0,0,16,0,Finland,82,0.18658635434823667,1.9205542909743523,0,3,0
5,8,6,0,1,0.0,223,3,13,229,Hong Kong,16,-0.3093130037344515,-1.9877613394887388,2,0,2
29,8,33,2,2,100.0,17,8,37,50,Netherlands,377,-1.6010977364637862,0.08429624163822103,1,0,1
5,8,1,0,2,0.0,0,0,13,1,Germany,192,0.2809055035964815,-0.14637416346417104,2,0,2
16,9,373,0,5,0.0,47,7,25,420,UK,362,-1.2540254256566563,-1.2476848314395539,1,0,1
26,9,1,3,1,0.0,1,0,35,2,Italy,15,-0.6642096762950995,-0.4527867883851329,1,0,2
11,8,23,0,3,100.0,0,0,19,23,Sweden,87,-0.45452496768596906,0.693531986486623,0,0,1
6,8,0,5,1,0.0,0,0,14,0,Netherlands,16,0.893075521786716,0.5476913776895767,3,3,0
5,15,3,0,1,0.0,8,1,20,11,France,166,-0.6270988905207139,-1.7132894472980227,2,0,2
3,8,1,0,1,0.0,0,0,11,1,France,591,1.1451057199666899,-1.3217155607992042,2,0,3
3,9,7,4,3,66.0,1,0,12,8,Italy,23,-0.26411404563186114,-0.5576212537320127,2,0,3
3,8,0,0,1,0.0,0,0,11,0,France,27,1.8211872325051166,-0.5087243978983329,3,3,3
6,8,0,0,1,0.0,0,0,14,0,US,681,1.155292251138641,0.2014957695955506,3,3,0
7,8,3,2,2,100.0,0,0,15,3,US,27,-0.456887128112475,0.9588112034297436,0,0,1
15,8,7,10,4,50.0,0,0,23,7,France,12,-0.6120988316265755,0.8702091113339393,0,0,1
42,16,31,9,11,90.0,3,5,58,34,US,21,-1.9016000381554763,-0.035467275727857135,1,0,1
30,8,0,0,1,0.0,0,0,38,0,US,578,0.7253800031136349,0.6056067220600769,3,3,0
20,8,8,1,1,0.0,0,0,28,8,US,111,-0.16330063154910382,-0.10353647806255513,2,0,2
5,8,20,1,1,0.0,0,0,13,20,US,93,0.20042418128922848,-0.5312821851740505,2,0,2
3,8,1,0,1,0.0,0,0,11,1,France,707,1.1451057199666899,-1.3217155607992042,2,0,3
5,8,3,1,1,0.0,0,0,13,3,France,153,0.28080513455466366,-0.43464540632237886,2,0,2
28,11,12,0,1,0.0,3,57,39,15,Italy,11,-0.9744077878992335,-1.5483685874022226,1,0,2
11,8,48,4,7,100.0,1,2,19,49,France,11,-1.3722041857289329,0.08241180155703443,1,0,1
10,14,42,0,1,0.0,5,1,24,47,Germany,85,-0.826986135955865,-1.6879088379819553,2,0,2
12,8,13,12,16,100.0,4,0,20,17,Australia,24,-1.1325754720289545,0.7434628921128028,1,0,1
20,9,0,0,2,0.0,0,0,29,0,Germany,298,0.3807742342599051,0.9738432915597872,3,3,0
3,9,38,4,1,0.0,33,3,12,71,France,16,-0.24198155428887277,-2.2127387482037664,2,0,3
10,48,191,0,1,0.0,11,6,58,202,Netherlands,12,-1.226055787014172,-1.7644366841730637,1,0,2
6,12,0,0,1,0.0,1,1,18,1,Italy,488,-0.15187023729256843,-1.1844892565245826,2,0,2
16,10,25,1,5,100.0,2,0,26,27,UK,11,-1.3525422677750583,0.5554323472824065,1,0,1
5,8,2,25,4,75.0,0,0,13,2,France,11,-0.24593565520998747,0.651762639871242,0,0,1
3,10,30,0,1,0.0,8,0,13,38,France,34,0.22073984984571093,-1.9262307545123905,2,0,3
25,30,410,3,2,100.0,45,2,55,455,Spain,11,-2.134811101279981,-0.15443628350085498,1,0,1
15,8,0,18,14,100.0,0,0,23,0,UK,29,-0.06315590801188986,2.2207059017611632,0,3,0
9,8,0,6,8,0.0,0,0,17,0,UK,665,0.4303261846671514,1.3108254720127683,0,3,0
3,8,1,0,1,0.0,0,0,11,1,France,691,1.1451057199666899,-1.3217155607992042,2,0,3
6,8,0,1,4,50.0,0,0,14,0,France,62,0.4651208449560285,1.4567390344346052,0,3,0
137,13,60,33,163,94.0,10,3,150,70,France,11,-2.242676945963261,0.3590722434797825,1,0,1
4,8,9,0,1,0.0,0,2,12,9,UK,642,0.2969745817849358,-1.403987050046016,2,0,2
4,8,0,1,2,0.0,1,0,12,1,Spain,600,0.17998862761312256,-0.013059474209415996,2,0,1
6,8,2,0,1,0.0,0,0,14,2,Sweden,188,0.4505653184351001,-0.645903716665331,2,0,2
24,8,0,0,5,100.0,0,0,32,0,France,12,0.15980974003937623,1.8659345880276668,0,3,0
5,11,0,2,1,0.0,0,0,16,0,France,540,0.6204447484788523,0.4405611553554108,3,3,0
4,9,0,3,2,100.0,3,1,13,3,France,31,-0.7103657914705546,0.1793146699695934,1,0,1
25,8,0,0,2,0.0,0,0,33,0,Spain,695,0.501913931012225,1.0953062901736403,3,3,0
4,8,8,0,1,0.0,1,0,12,9,Chypre,29,0.2620889625936842,-1.3415368608844145,2,0,2
7,8,1,2,12,83.0,0,1,15,1,France,14,-0.5971913498672098,0.32223446646912035,0,0,1
4,9,123,1,1,0.0,0,1,13,123,France,28,-0.29552558644825133,-1.2527168590455569,2,0,2
21,8,17,0,2,100.0,1,0,29,18,UK,455,-0.8861504187352404,0.365538150291885,1,0,1
71,9,22,0,18,66.0,14,11,80,36,Netherlands,14,-1.6089752866469178,-0.31933986578208473,1,0,1
6,10,36,5,1,0.0,1,1,16,37,Italy,11,-0.8124602531840648,-1.4291429154854007,2,0,2
25,8,1,0,4,75.0,0,0,33,1,Italy,12,-0.37052040387551793,0.7163475724437799,0,0,1
6,8,0,0,1,0.0,0,0,14,0,France,612,1.155292251138641,0.2014957695955506,3,3,0
3,8,0,2,1,0.0,0,0,11,0,France,217,1.5799460760545472,-0.1902221075939555,3,3,3
21,9,11,19,12,100.0,0,7,30,11,France,16,-1.3758915175919755,0.7229759187275636,1,0,1
9,8,5,3,1,100.0,1,0,17,6,UK,236,-0.6143876694399988,0.03212694742103941,1,0,1
6,8,107,0,1,0.0,3,0,14,110,Italy,28,-0.06622261178328046,-1.3390590474339998,2,0,2
25,8,0,0,2,100.0,0,0,33,0,France,319,0.1842071424532453,1.8092988262659713,0,3,0
7,8,0,0,7,100.0,0,0,15,0,France,11,0.4628210773959797,1.5903806715959738,0,3,0
7,8,1,0,1,0.0,0,0,15,1,Italy,666,0.4194671292710177,-0.5552771617958517,2,0,2
4,9,334,0,2,0.0,1,4,13,335,Italy,34,-0.7367801938552594,-1.5783395633944393,2,0,1
7,8,0,0,3,66.0,0,0,15,0,UK,61,0.6394881116780596,1.2009368509389093,0,3,0
4,13,142,0,1,0.0,2,6,17,144,Spain,11,-0.6924796430894857,-2.011006854143517,2,0,2
4,8,26,0,1,0.0,1,0,12,27,France,233,0.21068407685096313,-1.40335349502603,2,0,2
3,9,0,1,1,0.0,0,0,12,0,France,76,1.296514991719301,-0.17807809293114837,3,3,3
30,8,0,7,4,100.0,0,0,38,0,Chypre,17,-0.1606346837349672,2.261821375895363,0,3,0
8,8,475,1,1,0.0,11,10,16,486,Germany,11,-0.8165398126204548,-1.635938943238227,2,0,2
26,8,0,3,5,40.0,0,0,34,0,Italy,271,0.04650891020744602,1.86520232598959,0,3,0
40,9,51,1,6,0.0,7,33,49,58,Germany,14,-1.5666086826003836,-0.6301461984343405,1,0,1
11,8,0,1,2,0.0,0,0,19,0,UK,419,0.45929351398715595,1.2217624326092589,0,3,0
42,8,0,55,54,100.0,0,0,50,0,UK,23,-0.3556186992167676,2.547988754512358,0,3,0
5,8,0,0,1,0.0,0,0,13,0,UK,54,1.2296015562652718,0.13122512192593447,3,3,0
23,8,0,0,4,100.0,0,0,31,0,France,367,0.17909196300166974,1.8404022787686036,0,3,0
3,8,0,0,1,0.0,0,0,11,0,France,380,1.8211872325051166,-0.5087243978983329,3,3,3
25,8,0,0,4,100.0,0,0,33,0,Italy,147,0.15867059160626945,1.8594504502276774,0,3,0
6,8,14,1,1,0.0,11,1,14,25,UK,11,-0.49377786080992525,-1.4491281020427942,2,0,2
7,8,0,0,1,0.0,0,0,15,0,Germany,654,1.0955486418094451,0.2577140011050194,3,3,0
3,8,0,0,2,100.0,0,0,11,0,France,534,1.2308659038157737,0.7406600157047639,3,3,3
44,8,14,0,18,78.0,9,3,52,23,Italy,61,-1.3073069424501105,-0.22663370513915246,1,0,1
4,8,51,2,2,100.0,27,1,12,78,France,17,-0.986769150670397,-0.4531917136960099,1,0,1
7,8,2,8,4,75.0,1,0,15,3,France,21,-0.6758270001665229,0.2823020887197001,1,0,1
17,8,5,1,4,100.0,0,0,25,5,France,53,-0.7272119389662829,1.1894265436173528,0,0,1
4,8,0,0,3,100.0,0,0,12,0,France,610,0.7359512465560564,1.3053603161256242,0,3,0
6,8,0,0,1,0.0,0,0,14,0,France,657,1.155292251138641,0.2014957695955506,3,3,0
9,8,808,3,1,0.0,5,16,17,813,US,13,-0.9070758227348661,-1.6178164479606512,2,0,2
3,9,30,0,1,0.0,0,0,12,30,Finland,13,0.7033135767851988,-1.4663383715362186,2,0,3
4,8,0,0,2,0.0,13,0,12,13,Germany,252,0.3143340642195799,-0.4371630785281826,2,0,1
41,8,0,23,43,78.0,0,0,49,0,France,11,-0.17755438896532494,2.1758003602666167,0,3,0
7,8,0,0,1,0.0,0,1,15,0,US,670,0.8279118201684206,-0.22988848239913076,3,3,0
12,8,5,1,13,100.0,0,0,20,5,Monaco,19,-0.6878116510040185,1.1913923537097448,0,0,1
27,8,0,3,2,0.0,0,0,35,0,Spain,444,0.23403294890598167,1.4420521297830078,0,3,0
3,8,0,0,1,0.0,0,0,11,0,France,707,1.8211872325051166,-0.5087243978983329,3,3,3
3,8,1,3,1,0.0,0,0,11,1,Italy,34,0.8952545751914599,-0.9918458030143759,2,0,3
5,8,0,0,1,0.0,0,0,13,0,US,704,1.2296015562652718,0.13122512192593447,3,3,0
6,8,0,0,1,0.0,0,0,14,0,Spain,689,1.155292251138641,0.2014957695955506,3,3,0
6,8,20,6,9,88.0,10,0,14,30,Italy,13,-0.7746584848159042,0.1096629517503576,1,0,1
24,8,1,3,3,100.0,1,0,32,2,UK,424,-1.079306935927306,0.8828420150989081,1,0,1
7,8,1,0,3,100.0,0,0,15,1,France,407,-0.18649555355551284,0.7248255471495079,0,0,1
7,8,14,0,9,88.0,0,1,15,14,France,25,-0.4565897222156999,-0.14068646844885746,0,0,1
43,8,5,1,4,0.0,0,0,51,5,Italy,448,-0.6147110489808931,0.6699313678194905,0,0,1
20,8,0,0,1,0.0,0,0,28,0,Spain,264,0.8261692431966411,0.5112159095950009,3,3,0
12,8,0,1,2,0.0,0,0,20,0,UK,62,0.4357854572733043,1.243976693974413,0,3,0
23,10,67,2,5,60.0,6,3,33,73,Denmark,19,-1.6414492137252583,-0.3054048077478363,1,0,1
48,16,599,22,82,89.0,1016,32,64,1615,Germany,11,-2.3619294632434378,-0.32478056108958203,1,0,1
3,8,7,0,1,0.0,0,0,11,7,Denmark,43,1.0654312860744521,-1.4174186489287306,2,0,3
3,8,3,0,1,0.0,16,0,11,19,Germany,171,0.6984896091437175,-1.9382422087068965,2,0,3
8,8,0,0,1,0.0,0,0,16,0,Austria,130,1.0497295573481782,0.3009051053742669,3,3,0
46,192,274,22,9,88.0,47,0,238,321,Italy,11,-2.117257022299692,0.3829949471893894,1,0,1
30,8,0,1,3,100.0,0,0,38,0,Italy,301,-0.10850581664149693,2.1866284043398734,0,3,0
3,8,0,0,1,0.0,0,0,11,0,France,48,1.8211872325051166,-0.5087243978983329,3,3,3
9,8,9,0,4,100.0,2,3,17,11,UK,29,-0.983331113349266,-0.2771449205361974,1,0,1
5,8,0,0,1,0.0,0,0,13,0,Germany,706,1.2296015562652718,0.13122512192593447,3,3,0
3,8,32,2,1,0.0,40,4,11,72,Germany,13,0.06730779325457084,-2.2714522496198755,2,0,3
3,8,3,1,1,0.0,0,0,11,3,Denmark,55,0.8723908107945082,-1.074594926146646,2,0,3
79,421,1751,4,10,77.7,299,0,500,2050,Spain,55,-2.331515508169043,0.18339453364532565,1,0,1
4,8,0,6,1,0.0,0,0,12,0,Italy,13,1.0757364739826691,0.3766824238227604,3,3,0
3,8,0,0,1,0.0,0,0,11,0,France,698,1.8211872325051166,-0.5087243978983329,3,3,3
21,8,0,0,2,100.0,0,0,29,0,France,546,0.22548271924700183,1.7705444769131977,0,3,0
4,8,16,1,1,0.0,0,0,12,16,France,20,0.3226174469205804,-0.6253471499604942,2,0,2
4,8,11,0,1,0.0,0,0,12,11,France,34,0.568407894896405,-0.904783453833068,2,0,2
27,12,4,1,1,0.0,0,0,39,4,US,209,-0.49212233174425885,-0.1024510328737681,2,0,2
4,12,5,4,4,100.0,11,0,16,16,Italy,11,-1.117067442277903,0.2868461851787377,1,0,1
8,20,9,4,3,66.0,141,3,28,150,Portugal,32,-1.6563989371843841,-0.5258643510542912,1,0,1
10,9,35,8,10,100.0,14,0,19,49,Spain,12,-1.3149262680223361,0.4949705754331291,1,0,1
3,8,0,0,1,0.0,0,0,11,0,France,11,1.8211872325051166,-0.5087243978983329,3,3,3
5,8,0,0,6,83.0,0,0,13,0,France,45,0.7450409540053226,1.1322350279496771,0,3,0
9,8,1,0,1,0.0,1,0,17,2,UK,707,0.008631232753040795,-0.9454722549639211,2,0,2
5,7,0,0,1,0.0,0,0,12,0,France,676,1.5764075503289345,0.19238382440277627,3,3,2
19,8,1,15,30,83.0,0,1,27,1,Italy,13,-0.9323266697302388,0.6852767793803067,1,0,1
4,8,60,0,3,66.0,1,0,12,61,Austria,53,-0.2877797198842006,-0.5110611251555919,2,0,1
9,8,7,21,5,100.0,12,0,17,19,Italy,11,-1.0387106381704534,0.5964496885714703,1,0,1
24,9,0,2,3,0.0,0,0,33,0,UK,227,0.08148052785711583,1.3632060517318487,0,3,0
4,8,4,0,1,0.0,0,0,12,4,France,72,0.6087700080331391,-0.8562572957047054,2,0,2
3,8,4,1,1,0.0,2,0,11,6,Italy,90,0.5254568972267881,-1.5625485824404803,2,0,3
36,15,3,0,9,100.0,1,0,51,4,US,304,-1.3033623774611791,0.5486893252962587,1,0,1
22,9,1,0,1,0.0,0,0,31,1,US,695,-0.0440396320259922,-0.3542314628027904,2,0,2
8,8,5,0,2,100.0,3,0,16,8,UK,369,-0.6251954972537538,0.17400019622544563,1,0,1
52,44,73,15,19,100.0,3,3,96,76,UK,13,-2.2505965602189084,0.32328922536178833,1,0,1
12,8,133,2,4,100.0,0,4,20,133,UK,12,-1.1134104187847182,0.41120766148709686,1,0,1
27,8,24,0,1,0.0,0,0,35,24,France,62,-0.05402430392502501,-0.39779669542811347,2,0,2
9,8,0,0,1,0.0,0,0,17,0,US,705,1.015136275760136,0.33363313402552847,3,3,0
3,4,4,0,1,0.0,1,6,7,5,Netherlands,81,0.9863590805043377,-2.4412015123541386,2,0,3
10,8,0,0,2,100.0,0,0,18,0,US,618,0.39643275215540924,1.6096760028790886,0,3,0
43,23,894,3,8,62.5,290,174,66,1184,US,11,-2.2670578075084817,-0.6108722453376476,1,0,1
11,16,21,0,1,0.0,28,2,27,49,Australia,11,-0.8973854288314842,-1.709463502292581,1,0,2
8,8,1,0,1,0.0,2,0,16,3,Netherlands,47,0.025173317913945115,-1.0023619822873526,2,0,2
4,8,0,2,1,0.0,0,1,12,0,UK,17,0.8330359512909928,-0.14384258601950806,3,3,0
5,9,0,0,1,0.0,0,0,14,0,UK,132,1.0117480335209155,0.09572504937480934,3,3,0
46,41,70,0,1,0.0,67,5,87,137,Hong Kong,258,-1.3487754924551167,-1.5825535129188348,1,0,2
4,8,1,1,2,0.0,0,0,12,1,France,597,0.16529473978519532,0.048577295124595736,2,0,1
26,8,0,4,10,100.0,0,0,34,0,Spain,36,-0.1366565188219252,2.2640969090586016,0,3,0
3,8,0,0,1,0.0,0,0,11,0,UK,102,1.8211872325051166,-0.5087243978983329,3,3,3
22,8,16,0,4,75.0,0,1,30,16,UK,181,-0.7216714368859826,0.060595610375690986,1,0,1
5,8,0,0,1,0.0,0,0,13,0,France,383,1.2296015562652718,0.13122512192593447,3,3,0
3,8,1,2,2,100.0,0,0,11,1,France,647,0.31354323482677676,0.24617114310827035,0,0,3
4,8,3,1,2,100.0,0,0,12,3,France,47,-0.19720382101736444,0.7087714925350482,0,0,1
3,8,0,0,1,0.0,0,0,11,0,France,695,1.8211872325051166,-0.5087243978983329,3,3,3
4,8,1,0,1,0.0,0,0,12,1,France,666,0.6658324168441598,-0.7877335557206069,2,0,2
29,8,12,0,6,100.0,8,4,37,20,Spain,14,-1.320681706815836,-0.05602917255362545,1,0,1
58,34,148,22,10,100.0,2,3,92,150,Italy,11,-2.2569819172539285,0.2681938712628422,1,0,1
5,8,64,2,4,75.0,0,4,13,64,Denmark,25,-0.6317114574564325,-0.14544436089709734,1,0,1
12,8,3,0,6,66.0,3,0,20,6,France,372,-0.6091288579938361,0.03865000998805129,1,0,1
37,9,122,23,27,85.0,0,0,46,122,Italy,11,-1.2163061669600224,0.9884597422127787,1,0,1
15,8,6,7,11,100.0,44,1,23,50,France,13,-1.4781335520756471,0.18929963145034215,1,0,1
4,8,0,3,1,0.0,0,0,12,0,Italy,516,1.0920627846073576,0.3551273649650925,3,3,0
27,10,10,0,1,0.0,0,0,37,10,Italy,601,-0.24110588251063259,-0.437526229103133,2,0,2
7,8,0,3,4,60.0,0,0,15,0,Spain,12,0.3816479587693041,1.5459560993364172,0,3,0
49,35,1,0,4,100.0,0,0,84,1,Italy,18,-1.0684722107961537,1.06067910684214,1,0,1
8,9,2,3,2,0.0,0,0,17,2,France,41,-0.3675074318882954,0.26027579610045287,0,0,1
15,19,0,5,2,0.0,149,22,34,149,UK,12,-1.2270608673540853,-0.4606867743308915,1,0,1
4,8,18,0,1,0.0,5,3,12,23,Spain,114,-0.08741868282256458,-1.9443994834931546,2,0,2
35,11,8,2,27,55.0,1,0,46,9,Netherlands,30,-1.4027316515181478,0.5577893404926505,1,0,1
9,11,10,10,6,50.0,0,0,20,10,France,661,-0.8046591158890884,0.6875824926718825,0,0,1
37,11,143,2,5,60.0,14,2,48,157,Sweden,17,-1.8257719868781197,-0.2811467743580909,1,0,1
8,8,1,0,1,0.0,1,1,16,2,France,634,-0.2244123072999414,-1.4658027671193326,2,0,2
6,8,1,0,1,0.0,0,0,14,1,France,584,0.4792107386002136,-0.6114953933053205,2,0,2
3,8,0,2,1,0.0,0,0,11,0,Italy,11,1.5799460760545472,-0.1902221075939555,3,3,3
42,8,1,22,11,90.0,1,0,50,2,Italy,25,-1.1525989009422866,0.8320185872292659,1,0,1
13,8,0,3,3,100.0,0,0,21,0,Italy,41,0.05987036225852822,2.037236854388109,0,3,0
4,8,2,1,1,0.0,3,0,12,5,Italy,15,0.05861275449191958,-1.0152831048148052,2,0,2
7,8,1,0,1,0.0,0,0,15,1,France,706,0.4194671292710177,-0.5552771617958517,2,0,2
6,8,0,0,1,0.0,0,1,14,0,US,681,0.8876554294976163,-0.2861067139085992,3,3,0
4,8,0,0,1,0.0,0,0,12,0,France,676,1.3419139293825872,0.025257607180264305,3,3,0
8,9,3,7,14,100.0,0,0,17,3,France,27,-0.7881383474099228,1.112232776536235,0,0,1
9,13,7,0,1,0.0,4,1,22,11,Spain,180,-0.709277985648297,-1.614129452751245,2,0,2
7,8,1,0,1,0.0,0,0,15,1,Netherlands,617,0.4194671292710177,-0.5552771617958517,2,0,2
6,8,3,0,1,0.0,1,0,14,4,Austria,273,0.11223076097302859,-1.1212429787612535,2,0,2
11,15,2,0,2,50.0,0,0,26,2,Italy,201,-0.5478649397477411,0.37250655442577,0,0,1
13,12,6,1,6,100.0,0,0,25,6,UK,14,-0.9889596128324653,1.0617878287819105,0,0,1
14,37,4,4,8,87.0,0,0,51,4,UK,11,-1.117829060290298,0.8951507604967585,1,0,1
8,8,312,1,5,60.0,123,18,16,435,Ireland,14,-1.322122047354916,-0.7203459113940044,1,0,1
4,13,14,4,1,0.0,11,0,17,25,Germany,114,-0.5718052675171226,-1.0379502841665127,2,0,2
5,8,0,2,1,0.0,0,0,13,0,UK,42,0.9883603998147025,0.4497274122303117,3,3,0
4,8,0,0,1,0.0,0,0,12,0,France,285,1.3419139293825872,0.025257607180264305,3,3,0
63,8,2,7,49,86.4,0,0,71,2,Italy,12,-0.9539478316132686,1.3964753758643147,0,0,1
6,10,13,4,5,80.0,117,85,16,130,Finland,11,-1.4588526954318135,-0.7284628626804912,1,0,1
11,8,17,0,4,75.0,1,0,19,18,France,12,-0.6207693094158007,-0.05013042217547976,1,0,1
32,8,0,0,2,100.0,0,0,40,0,Germany,430,0.11722813304492466,1.8722548213209955,0,3,0
44,8,1,0,15,31.0,0,0,52,1,Italy,26,-0.5355131291052897,0.9063734582856583,0,0,1
5,8,0,0,1,0.0,0,0,13,0,France,632,1.2296015562652718,0.13122512192593447,3,3,0
4,8,0,1,2,0.0,0,0,12,0,Italy,633,0.8413762523236226,0.861568458025467,3,3,0
8,8,1,2,12,75.0,0,0,16,1,Italy,19,-0.3719800875621875,0.8454016776659569,0,0,1
26,10,2,0,1,0.0,27,1,36,29,Italy,37,-0.8635364311428856,-1.4522537521964562,1,0,2
8,11,3,10,4,100.0,0,0,19,3,Sweden,13,-0.8708140481719137,1.0405129138483713,0,0,1
3,8,0,0,1,0.0,0,0,11,0,France,263,1.8211872325051166,-0.5087243978983329,3,3,3
103,431,7,13,66,93.0,0,0,534,7,Italy,15,-1.7201151758500932,1.3381926336917667,1,0,1
6,8,0,0,8,88.0,0,0,14,0,UK,189,0.6593178009003274,1.2258091718661932,0,3,0
4,8,0,0,3,100.0,0,0,12,0,France,458,0.7359512465560564,1.3053603161256242,0,3,0
4,8,0,0,2,100.0,0,0,12,0,US,377,0.7515926006932439,1.2746420207833618,0,3,0
5,8,0,0,1,0.0,0,0,13,0,France,383,1.2296015562652718,0.13122512192593447,3,3,0
10,7,3,3,1,0.0,236,81,17,239,UK,11,-0.5712316763676175,-1.4313111939125251,2,0,2
7,8,0,2,4,75.0,0,0,15,0,Portugal,63,0.3853401228791961,1.5456406140911727,0,3,0
7,10,1,0,14,92.0,0,1,17,1,France,120,-0.6381048679897027,-0.026521198926662427,1,0,1
4,8,0,0,2,0.0,0,0,12,0,Italy,120,1.0692993892522238,0.5606494846910302,3,3,0
12,8,0,7,10,75.0,0,0,20,0,UK,11,0.16888171551009806,1.789381461863604,0,3,0
28,8,87,0,1,0.0,0,3,36,87,Belgium,11,-0.41644237832726877,-0.9900607206632719,2,0,2
7,8,1,1,3,66.0,0,0,15,1,Spain,592,-0.2645165377889689,0.6888646613724749,0,0,1
28,8,0,0,1,0.0,4,1,36,4,France,142,-0.23086395915063365,-0.8404194282017817,2,0,2
6,10,6,0,1,0.0,0,0,16,6,France,640,0.11696587056401178,-0.7388516356885872,2,0,2
32,11,0,17,3,66.0,0,0,43,0,Grèce,18,-0.28949349224413184,1.842993814863457,0,3,0
5,8,0,4,2,0.0,0,0,13,0,France,11,0.6998064959614978,1.0061634760914262,3,3,0
10,8,0,5,4,50.0,1,1,18,1,Ireland,17,-0.6667353641127083,0.2985810731356035,1,0,1
5,8,0,1,1,0.0,0,0,13,0,UK,455,1.0016784193366708,0.4321440952603711,3,3,0
5,8,0,0,1,0.0,0,1,13,0,Ireland,679,0.9619647346242478,-0.35637736157821553,3,3,0
85,0,115,54,73,90.0,4,0,85,119,Spain,11,-0.8411806027679055,1.1570751657145306,0,2,2
11,10,153,27,13,92.0,63,6,21,216,Belgium,11,-1.7086307176064004,-0.41774813587403126,1,0,1
172,50,778,96,34,64.0,2,0,222,780,Italy,11,-2.1837012653769383,0.6019761152221498,1,0,1
9,8,7,1,1,0.0,0,1,17,7,Luxembourg,15,-0.2361796292401546,-0.7617446271745821,2,0,2
8,10,3,3,1,0.0,49,0,18,52,Austria,16,-0.6243858781557193,-0.9194273571210914,2,0,2
6,8,1,2,1,0.0,1,0,14,2,France,102,-0.0924539483190239,-0.7591073290895215,2,0,2
22,9,36,51,18,70.0,1,0,31,37,Italy,11,-1.3490502012698529,0.4873293050234123,1,0,1
5,8,0,0,1,0.0,0,0,13,0,UK,358,1.2296015562652718,0.13122512192593447,3,3,0
11,10,14,5,18,83.0,19,0,21,33,UK,12,-1.2396909652290298,0.23735208175990408,1,0,1
7,8,0,1,3,100.0,0,0,15,0,France,379,0.2616628220543133,1.8387356833848154,0,3,0
15,11,5,0,1,0.0,0,0,26,5,Belgium,586,-0.1255820796769045,-0.5270797318984777,2,0,2
12,11,6,1,8,100.0,5,0,23,11,Italy,12,-1.307532319459701,0.5645159330067865,1,0,1
6,9,2,0,1,0.0,1,0,15,3,Slovaquie,19,-0.08203547207475509,-1.1477095830624306,2,0,2
5,9,41,2,3,66.0,5,0,14,46,Italy,12,-0.867321650503734,-0.13723880232431734,1,0,1
4,8,0,0,1,0.0,1,1,12,1,US,149,0.41288948303106254,-1.3369728085587682,2,0,2
3,8,0,1,2,100.0,0,0,11,0,France,138,1.0029427668871727,1.0415789890392004,0,3,3
8,10,16,1,1,0.0,0,0,18,16,France,30,-0.2281432896350159,-0.41421331651305193,2,0,2
11,11,159,1,11,90.9,11,1,22,170,Italy,13,-1.596284152573427,-0.4311322805421376,1,0,1
4,9,4,1,9,100.0,0,1,13,4,France,11,-0.7722646411208506,0.29184274003910166,1,0,1
6,8,1,0,1,0.0,0,0,14,1,Italy,460,0.4792107386002136,-0.6114953933053205,2,0,2
8,10,45,0,1,0.0,4,10,18,49,Germany,105,-0.700384798816604,-1.8213009244362253,2,0,2
6,8,2,2,1,0.0,0,0,14,2,Italy,477,0.20932416198453016,-0.3274014263609536,2,0,2
12,11,0,1,5,100.0,1,22,23,1,France,44,-1.1781473007870216,0.4718815957422344,1,0,1
3,8,5,5,1,0.0,0,0,11,5,France,21,0.817004917037194,-1.0546484311450404,2,0,3
21,8,1,5,29,100.0,0,0,29,1,UK,198,-0.8016813521241541,1.4782738879043156,0,0,1
3,8,0,0,1,0.0,0,0,11,0,France,694,1.8211872325051166,-0.5087243978983329,3,3,3
4,8,0,0,1,0.0,0,0,12,0,Italy,424,1.3419139293825872,0.025257607180264305,3,3,0
5,8,0,3,1,0.0,0,0,13,0,UK,427,0.9797504114900423,0.46109487971076263,3,3,0
3,8,0,0,2,0.0,0,2,11,0,Italy,15,1.2695584968941998,-0.48166322695868624,3,3,3
28,9,42,1,5,80.0,0,0,37,42,France,24,-0.9726362685966362,0.7928940760851412,1,0,1
4,8,0,0,1,0.0,0,0,12,0,UK,662,1.3419139293825872,0.025257607180264305,3,3,0
5,8,1,4,1,0.0,0,0,13,1,UK,15,0.296339523553434,-0.34221956432021083,2,0,2
4,8,0,18,18,84.0,0,0,12,0,Italy,29,0.5299288628290761,1.4822782029984272,0,3,0
14,8,0,13,11,100.0,0,0,22,0,France,28,-0.032828375247765385,2.1805933804674402,0,3,0
5,10,9,0,1,0.0,1,0,15,10,France,23,-0.162800647626845,-1.2635537375515327,2,0,2
6,8,51,6,6,85.0,29,14,14,80,UK,14,-1.1426292295646716,-0.5766220442011919,1,0,1
7,8,0,0,12,91.0,0,0,15,0,Italy,295,0.582275623721507,1.3166693302097447,0,3,0
15,8,1,3,11,100.0,0,0,23,1,Italy,12,-0.6890551436787913,1.3356160832073631,0,0,1
3,8,0,0,2,0.0,0,0,11,0,Italy,305,1.548572692374754,0.026667479612432644,3,3,3
7,8,0,0,2,100.0,0,0,15,0,France,272,0.5052273131201019,1.5070984147081161,0,3,0
52,8,0,32,55,100.0,0,0,60,0,UK,86,-0.39492693714378097,2.581321579724298,0,3,0
6,8,25,2,8,100.0,14,2,14,39,UK,27,-1.186020875381681,-0.151268744526052,1,0,1
6,8,0,0,3,100.0,0,0,14,0,France,332,0.5493295683121103,1.4815984785409098,0,3,0
7,8,0,0,1,0.0,0,0,15,0,France,29,1.0955486418094451,0.2577140011050194,3,3,0
89,61,10,1,14,91.6,0,0,150,10,Spain,11,-1.4187553016075536,1.094407766506226,1,0,1
4,8,2,0,1,0.0,0,1,12,2,Italy,324,0.3695501750380215,-1.3097443625847673,2,0,2
4,8,0,0,2,0.0,0,0,12,0,France,44,1.0692993892522238,0.5606494846910302,3,3,0
10,12,182,0,2,0.0,2,5,22,184,France,89,-1.1504996350628485,-1.2870650345066832,1,0,1
4,8,24,0,1,0.0,3,3,12,27,Sweden,30,-0.09004063843498954,-1.9456872900028075,2,0,2
7,12,42,0,1,0.0,2,1,19,44,Italy,15,-0.6950239041110841,-1.7472265275685825,2,0,2
24,8,6,4,5,100.0,12,0,32,18,UK,22,-1.2273476571257294,0.7689986612547283,1,0,1
6,8,19,0,2,100.0,0,0,14,19,US,153,-0.23336095436653104,0.49095638966095495,0,0,1
4,8,0,0,1,0.0,0,0,12,0,US,650,1.3419139293825872,0.025257607180264305,3,3,0
6,8,0,0,1,0.0,0,0,14,0,UK,689,1.155292251138641,0.2014957695955506,3,3,0
12,8,1,8,13,90.9,0,0,20,1,France,15,-0.5291265329618621,1.019756814438831,0,0,1
19,8,125,7,6,100.0,0,4,27,125,Germany,12,-1.2520680664554589,0.5715447491312996,1,0,1
24,9,5,6,5,100.0,1,0,33,6,US,265,-1.3403680833327805,0.7986095754047872,1,0,1
5,8,3,0,1,0.0,23,2,13,26,Austria,524,-0.18585743325754447,-1.8246226912004835,2,0,2
8,9,1,1,1,0.0,1,17,17,2,Spain,13,-0.6937123342065894,-1.3168970002551872,2,0,2
15,8,0,0,3,100.0,0,0,23,0,France,250,0.2786276490833162,1.7367437568321016,0,3,0
36,8,3,21,21,90.0,0,0,44,3,Lettonie,12,-0.8584222954230887,1.2558295978316596,0,0,1
3,8,1,0,1,0.0,0,0,11,1,Germany,129,1.1451057199666899,-1.3217155607992042,2,0,3
5,8,0,0,3,100.0,0,0,13,0,France,58,0.6236388734387416,1.4113278308712944,0,3,0
3,8,0,0,1,0.0,0,0,11,0,France,398,1.8211872325051166,-0.5087243978983329,3,3,3
14,8,0,20,22,100.0,0,0,22,0,Italy,12,-0.06394785986399532,2.235555689049237,0,3,0
4,8,2,1,4,100.0,2,0,12,4,Italy,456,-0.5468334215966171,0.29820218637239887,0,0,1
4,8,4,1,4,50.0,1,0,12,5,UK,57,-0.402241317933222,-0.05529906947657137,0,0,1
4,8,0,1,1,0.0,0,1,12,0,UK,23,0.8463539708129616,-0.16142590298944873,3,3,0
7,8,0,2,4,75.0,1,0,15,1,Netherlands,11,-0.27604750183130394,0.6710126818562901,0,0,1
96,0,3,0,50,96.0,214,32,96,217,Spain,13,-0.8686510983171107,0.10550498941290921,1,2,2
12,8,1,1,14,92.0,0,0,20,1,Germany,222,-0.4869574182846585,0.9664761466411654,0,0,1
13,8,2,3,1,0.0,0,0,21,2,Italy,17,-0.03889388761848219,-0.09026534081813176,2,0,2
4,8,208,1,1,0.0,31,11,12,239,Germany,11,-0.5044778725013076,-1.8931340828407248,2,0,2
38,30,61,2,3,100.0,11,0,68,72,Italy,15,-1.795965070556678,0.5979101536683524,1,0,1
5,8,1,0,1,0.0,0,0,13,1,France,610,0.5535200437268449,-0.6817660409749369,2,0,2
5,0,4,4,2,100.0,1,2,5,5,UK,26,0.258235332808097,-0.17870385272067324,0,1,2
14,8,0,6,9,55.0,0,2,22,0,France,33,-0.1333708601839271,1.2906741975040126,0,3,0
3,8,0,2,1,0.0,0,0,11,0,France,111,1.5799460760545472,-0.1902221075939555,3,3,3
4,8,41,0,1,0.0,0,2,12,41,France,162,0.2241313556033617,-1.4916407774137996,2,0,2
4,8,0,0,1,0.0,0,2,12,0,UK,582,1.062899733902033,-0.48307309939085447,3,3,0
4,8,1,0,2,0.0,0,0,12,1,France,203,0.39321787671379643,-0.252341678209841,2,0,2
3,8,0,0,1,0.0,0,0,11,0,France,331,1.8211872325051166,-0.5087243978983329,3,3,3
4,8,0,1,1,0.0,0,0,12,0,France,234,1.1139907924539865,0.32617658051470094,3,3,0
3,8,4,0,1,0.0,0,0,11,4,France,21,1.0880433111556689,-1.3902393007833025,2,0,3
9,8,0,1,2,0.0,175,3,17,175,Germany,11,-0.6387792201536742,-0.49576285090541805,1,0,1
23,8,5,0,1,0.0,7,0,31,12,France,61,-0.3110193745631742,-0.8642401565093693,2,0,2
4,8,0,0,4,75.0,0,0,12,0,France,47,0.8729465669029078,0.9946819298620407,3,3,0
15,9,2,0,3,0.0,0,1,24,2,UK,244,-0.5525190031352176,-0.38194862621414294,1,0,1
5,8,11,18,1,0.0,38,1,13,49,Romania,14,-0.5160712093896754,-1.4819259278672525,2,0,2
6,8,0,0,1,0.0,0,0,14,0,France,23,1.155292251138641,0.2014957695955506,3,3,0
8,8,12,16,2,100.0,0,0,16,12,France,20,-0.6065093331167324,0.995758755062646,0,0,1
5,8,0,4,8,87.0,0,0,13,0,France,51,0.47699654651707646,1.4938490568203775,0,3,0
5,8,16,1,2,0.0,0,0,13,16,UK,517,-0.06230946632709803,0.016012242295941496,2,0,1
15,8,41,1,1,0.0,6,1,23,47,Grèce,73,-0.7959210959912332,-1.2291409198933951,2,0,2
5,8,0,2,1,0.0,0,0,13,0,France,630,0.9883603998147025,0.4497274122303117,3,3,0
13,29,320,3,1,0.0,24,8,42,344,Spain,11,-1.4585195481330115,-1.499680532778937,1,0,2
7,8,0,0,2,100.0,0,0,15,0,UK,394,0.5052273131201019,1.5070984147081161,0,3,0
4,8,0,1,1,0.0,0,0,12,0,France,14,1.1139907924539865,0.32617658051470094,3,3,0
16,8,128,9,3,100.0,0,7,24,128,Grèce,11,-1.2140333380980364,0.48340325467625045,1,0,1
21,2,61,11,11,100.0,225,1,23,286,France,24,-1.3332868336323054,0.20475387647434512,1,0,1
12,8,0,0,1,0.0,0,0,20,0,France,116,0.9363231343322689,0.40766584312921067,3,3,0
13,8,1,6,9,100.0,0,0,21,1,UK,11,-0.6670131781852161,1.3135081404004023,0,0,1
10,8,7,8,9,50.0,6,2,18,13,Croatie,309,-1.164489244984842,-0.19598851267924636,1,0,1
3,8,1,1,1,0.0,0,0,11,1,France,36,0.9171825830380885,-1.020796587464767,2,0,3
22,9,0,0,7,85.7,0,0,31,0,Italy,252,0.14080375954991348,1.473452659614717,0,3,0
22,9,20,13,22,100.0,0,0,31,20,UK,14,-1.1234680461265965,1.2760240648297039,0,0,1
8,8,0,3,4,50.0,0,0,16,0,UK,23,0.337630143318937,1.5850991546637132,0,3,0
18,8,1,4,18,100.0,0,0,26,1,Sweden,22,-0.7502290788358099,1.412198518644798,0,0,1
5,8,1,0,1,0.0,0,0,13,1,Spain,687,0.5535200437268449,-0.6817660409749369,2,0,2
31,13,9,1,5,66.0,0,0,44,9,Italy,484,-1.0431945953383184,0.8586770956877922,1,0,1
4,8,0,0,2,0.0,0,0,12,0,France,294,1.0692993892522238,0.5606494846910302,3,3,0
5,8,0,0,6,100.0,0,0,13,0,France,199,0.6015439620739472,1.454720366256142,0,3,0
13,8,3,0,1,0.0,1,0,21,4,UK,360,-0.12737730030532363,-0.8954743606988822,2,0,2
5,0,0,0,1,0.0,0,0,5,0,UK,343,2.4387352182846023,0.07649590508851316,3,1,2
8,11,554,9,4,50.0,31,15,19,585,UK,11,-1.6706260237622765,-0.7333445907949979,1,0,1
8,14,10,0,1,0.0,2,6,22,12,France,42,-0.736368926537055,-1.6841183030624638,2,0,2
4,9,95,0,1,0.0,119,7,13,214,Netherlands,12,-0.5050494618976561,-2.1866659750927875,2,0,2
5,8,0,0,3,100.0,0,0,13,0,France,647,0.6236388734387416,1.4113278308712944,0,3,0
13,8,0,0,4,100.0,0,0,21,0,France,430,0.29982631032396984,1.726800425222725,0,3,0
5,13,15,0,1,0.0,6,1,18,21,Belgium,41,-0.6221157305688135,-1.7888862478202365,2,0,2
3,10,30,1,2,0.0,14,10,13,44,Denmark,11,-0.6038350701429722,-1.673508135634851,2,0,3
3,8,0,0,2,50.0,0,0,11,0,France,267,1.3844755140980813,0.395448269644579,3,3,3
6,8,12,0,1,0.0,0,1,14,12,UK,16,0.10996799127287413,-1.2211776635708587,2,0,2
4,8,0,0,1,0.0,0,0,12,0,Belgium,533,1.3419139293825872,0.025257607180264305,3,3,0
9,8,36,0,3,66.0,3,1,17,39,Romania,34,-0.8755397045799811,-0.6858864460713481,1,0,1
16,8,1,11,3,66.6,0,0,24,1,US,442,-0.5447582862437651,0.97485044488491,0,0,1
7,8,0,0,1,0.0,0,0,15,0,US,575,1.0955486418094451,0.2577140011050194,3,3,0
4,8,0,0,1,0.0,0,0,12,0,France,336,1.3419139293825872,0.025257607180264305,3,3,0
9,8,5,21,15,93.0,0,0,17,5,France,11,-0.5453136065837948,0.9096944051399894,0,0,1
62,209,1533,12,7,100.0,11,0,271,1544,Italy,11,-2.3408400976080834,0.6049619229633021,1,0,1
8,10,6,3,10,90.0,7,2,18,13,Italy,11,-1.35406007459439,-0.3111145669480356,1,0,1
3,8,26,1,1,0.0,1,2,11,27,France,11,0.18302004756433773,-2.144747233341309,2,0,3
14,25,41,0,2,100.0,457,38,39,498,Italy,11,-1.8272909550977807,-0.6687811328816267,1,0,1
4,8,0,1,3,100.0,0,0,12,0,France,217,0.5080281096274553,1.606279289460061,0,3,0
4,8,0,0,3,100.0,0,0,12,0,France,542,0.7359512465560564,1.3053603161256242,0,3,0
7,8,0,0,5,0.0,0,0,15,0,Germany,21,0.7900532357262511,0.8576811156821843,3,3,0
15,9,4,0,1,0.0,1,0,24,5,Swiss,471,-0.34588319565629777,-0.9488567707980303,2,0,2
3,8,8,1,1,0.0,8,0,11,16,UK,11,0.46874433638846846,-1.6355836749976453,2,0,3
4,8,0,0,1,0.0,0,0,12,0,Netherlands,584,1.3419139293825872,0.025257607180264305,3,3,0
10,9,0,0,1,0.0,0,0,19,0,France,46,0.8012776542156352,0.2980235545041716,3,3,0
5,8,0,0,1,0.0,0,0,13,0,France,671,1.2296015562652718,0.13122512192593447,3,3,0
6,9,0,0,1,0.0,0,4,15,0,Sweden,328,0.6554720875732133,-0.3728257366699066,3,3,0
11,9,76,3,10,80.0,8,1,20,84,Spain,194,-1.4593968384881577,-0.349497461433484,1,0,1
38,9,0,5,28,96.0,0,0,47,0,Italy,14,-0.2941695485623464,2.036774504558785,0,3,0
5,8,0,0,1,0.0,0,1,13,0,US,274,0.9619647346242478,-0.35637736157821553,3,3,0
5,0,2,0,1,0.0,0,0,5,2,Lettonie,447,1.7340082855810608,-0.7709035811723688,2,1,2
44,9,71,0,20,85.0,1,4,53,72,Germany,348,-1.5233155759372023,-0.3340502776636981,1,0,1
5,8,2,0,1,0.0,0,0,13,2,France,635,0.5248746235617312,-0.7161743643349475,2,0,2
4,12,55,0,1,0.0,21,0,16,76,Denmark,83,-0.34956549760329814,-1.4813050419866345,2,0,2
7,11,399,0,2,100.0,4,74,18,403,China,38,-1.4660948793652975,-0.8222845179773066,1,0,1
5,9,0,0,1,0.0,0,0,14,0,France,17,1.0117480335209155,0.09572504937480934,3,3,0
3,8,6,0,1,0.0,0,3,11,6,UK,618,0.7858055402946411,-1.9308365456525263,2,0,3
3,8,1,1,1,0.0,0,0,11,1,France,187,0.9171825830380885,-1.020796587464767,2,0,3
4,8,23,0,3,100.0,1,0,12,24,Australia,17,-0.3899834537480229,-0.11687539990411891,0,0,1
11,8,150,1,2,100.0,5,33,19,155,France,11,-1.4417404106892329,-0.24837311967995596,1,0,1
4,8,0,1,2,0.0,0,0,12,0,UK,160,0.8413762523236226,0.861568458025467,3,3,0
4,8,1,2,1,0.0,0,0,12,1,France,54,0.42459126039359013,-0.46923126541622934,2,0,2
20,9,7,0,11,90.0,1,0,29,8,Italy,26,-0.9304829867989889,0.12643323340876114,1,0,1
11,8,2,0,10,72.7,3,1,19,5,UK,324,-0.8594713393328841,-0.4208140411165906,1,0,1
3,8,0,0,1,0.0,0,0,11,0,France,672,1.8211872325051166,-0.5087243978983329,3,3,3
3,8,11,0,1,0.0,14,0,11,25,UK,106,0.6674409778405339,-1.974383841259027,2,0,3
6,8,3,0,1,0.0,0,0,14,3,Sweden,680,0.4344189663566338,-0.6652937319871997,2,0,2
6,8,2,0,1,0.0,0,0,14,2,Germany,90,0.4505653184351001,-0.645903716665331,2,0,2
6,8,0,1,2,100.0,0,0,14,0,France,66,0.33704778552069653,1.7517991565330844,0,3,0
7,8,0,1,2,0.0,0,0,15,0,Italy,233,0.5950109647504807,1.0940248519502218,0,3,0
7,9,27,3,2,100.0,0,1,16,27,France,11,-1.026393542864929,0.31667998769420697,1,0,1
3,8,0,2,1,0.0,1,0,11,1,Italy,544,0.9185584513440472,-1.064850039828838,2,0,3
4,8,0,1,2,100.0,0,0,12,0,UK,483,0.5236694637646426,1.5755609941177986,0,3,0
4,8,2,1,1,0.0,0,0,12,2,France,695,0.4092638597504449,-0.5212229057461806,2,0,2
3,8,0,0,1,0.0,0,0,11,0,Italy,605,1.8211872325051166,-0.5087243978983329,3,3,3
8,8,1,0,1,0.0,1,0,16,2,France,217,0.04322451434108308,-0.9782002836151825,2,0,2
3,8,0,0,1,0.0,0,0,11,0,France,632,1.8211872325051166,-0.5087243978983329,3,3,3
12,8,0,1,8,100.0,0,0,20,0,France,12,0.07206057315162169,2.048344873900722,0,3,0
5,8,0,0,1,0.0,0,0,13,0,Spain,658,1.2296015562652718,0.13122512192593447,3,3,0
4,8,0,2,2,50.0,0,0,12,0,UK,21,0.6639610545249819,1.2479325650275535,0,3,0
7,8,0,0,7,71.0,0,0,15,0,France,277,0.6109449037647978,1.2574973016042132,0,3,0
4,8,21,0,1,0.0,6,2,12,27,Spain,53,-0.0906603514174437,-1.9445114902988039,2,0,2
12,12,5,0,1,0.0,2,16,24,7,Germany,11,-0.7622820323603378,-1.6188854871959524,2,0,2
7,8,0,0,1,0.0,0,0,15,0,Italy,351,1.0955486418094451,0.2577140011050194,3,3,0
6,8,0,0,1,0.0,0,0,14,0,France,346,1.155292251138641,0.2014957695955506,3,3,0
9,8,3,2,9,88.0,0,0,17,3,Spain,206,-0.44705159156586766,0.8177093665815784,0,0,1
10,8,42,0,1,0.0,6,2,18,48,Finland,101,-0.47858013333747995,-1.6487671469055303,2,0,2
3,8,1,0,1,0.0,0,0,11,1,Italy,305,1.1451057199666899,-1.3217155607992042,2,0,3
3,8,1,0,1,0.0,0,0,11,1,Italy,248,1.1451057199666899,-1.3217155607992042,2,0,3
8,8,0,2,9,88.0,0,0,16,0,Sweden,12,0.30841497480418184,1.6517708395130677,0,3,0
4,8,1,2,1,0.0,0,0,12,1,UK,21,0.42459126039359013,-0.46923126541622934,2,0,2
4,8,1,0,1,0.0,0,0,12,1,Belgium,704,0.6658324168441598,-0.7877335557206069,2,0,2
23,9,60,8,7,71.0,3,0,32,63,Italy,77,-1.3280360190117446,0.327490345077317,1,0,1
4,8,0,0,1,0.0,0,0,12,0,France,179,1.3419139293825872,0.025257607180264305,3,3,0
6,8,1,0,2,50.0,13,2,14,14,France,31,-0.6480954056579935,-0.7896208712738372,1,0,1
3,8,16,3,1,0.0,2,17,11,18,Italy,34,0.1318505930316221,-2.177916865000643,2,0,3
10,9,0,0,1,0.0,0,0,19,0,Italy,561,0.8012776542156352,0.2980235545041716,3,3,0
17,9,16,8,31,90.0,1,0,26,17,Spain,17,-1.24115802277751,0.4855651018923069,1,0,1
19,9,11,22,11,81.0,8,0,28,19,Italy,16,-1.273170362812215,0.4210230036440177,1,0,1
28,8,0,0,28,89.0,0,0,36,0,France,15,0.20876825440428487,1.6930077491855282,0,3,0
8,8,0,0,3,66.0,0,2,16,0,France,565,0.31465483173623865,0.7357972486370384,0,3,0
6,8,0,0,1,0.0,0,0,14,0,Germany,704,1.155292251138641,0.2014957695955506,3,3,0
3,12,38,0,1,0.0,17,0,15,55,Lettonie,11,0.05106441245018693,-1.9094812838362183,2,0,3
6,10,0,4,3,0.0,23,1,16,23,France,20,-0.7261853469546684,-0.44964840650556664,1,0,1
5,8,3,0,2,0.0,0,0,13,3,Netherlands,421,0.2361137313529015,-0.2001725021460501,2,0,2
6,8,0,0,1,0.0,0,0,14,0,France,664,1.155292251138641,0.2014957695955506,3,3,0
3,8,0,0,2,0.0,0,0,11,0,UK,57,1.548572692374754,0.026667479612432644,3,3,3
7,8,0,2,7,85.0,0,0,15,0,Spain,22,0.3635778090104953,1.5897666072288044,0,3,0
6,9,0,0,2,50.0,0,0,15,0,France,684,0.5102080071822838,1.0623298921737547,0,3,0
7,9,2,0,6,66.0,3,0,16,5,Italy,162,-0.6362649229076571,-0.14881283070256587,1,0,1
5,8,0,0,1,0.0,0,1,13,0,Spain,659,0.9619647346242478,-0.35637736157821553,3,3,0
31,8,84,4,30,100.0,19,0,39,103,UK,14,-1.4683779837819138,0.8023200391046031,1,0,1
8,24,206,0,1,0.0,14,7,32,220,UK,75,-1.0655448592845398,-1.8799297891979008,1,0,2
3,9,0,4,3,100.0,0,0,12,0,France,20,0.6612949256479608,1.1406521193345007,0,3,3
6,8,18,11,1,0.0,5,0,14,23,Hong Kong,11,-0.2692200928615026,-0.8757372204618092,2,0,2
4,8,0,1,1,0.0,0,0,12,0,France,83,1.1139907924539865,0.32617658051470094,3,3,0
10,8,6,3,1,0.0,0,0,18,6,Romania,271,-0.012436018113327466,-0.2108149248620865,2,0,2
5,8,0,4,3,100.0,0,0,13,0,France,112,0.3664583532653305,1.7508743075260198,0,3,0
10,8,7,0,4,100.0,0,0,18,7,France,614,-0.3848597451222311,0.7511333758103979,0,0,1
22,8,0,2,44,89.1,0,0,30,0,France,11,0.014559259546808983,1.9803707745504515,0,3,0
5,8,0,2,1,0.0,0,0,13,0,France,15,0.9883603998147025,0.4497274122303117,3,3,0
4,9,7,1,1,0.0,0,0,13,7,Italy,16,0.11319855554611674,-0.5955442236030315,2,0,2
5,8,8,6,3,100.0,12,4,13,20,France,11,-1.0725290911116971,-0.2149126935264921,1,0,1
14,9,1,1,1,0.0,0,0,23,1,Spain,14,-0.18083640146459962,-0.13935355502530927,2,0,2
4,8,3,6,4,100.0,18,1,12,21,UK,12,-0.9356759410222897,-0.24777901142519934,1,0,1
3,8,0,0,1,0.0,0,0,11,0,France,100,1.8211872325051166,-0.5087243978983329,3,3,3
14,8,1,5,11,100.0,0,0,22,1,Italy,11,-0.6861425652684576,1.3375433152105651,0,0,1
3,9,8,2,2,0.0,1,0,12,9,France,20,-0.06924253472193395,-0.9918973665151208,2,0,3
14,12,386,3,1,0.0,21,1,26,407,France,11,-1.2443852145421803,-1.4849961566040584,1,0,2
6,8,0,0,1,0.0,11,2,14,11,France,11,0.12904275592850611,-1.2943738389030883,2,0,2
8,8,1,3,2,0.0,0,0,16,1,Croatie,422,-0.14881764009584234,0.35317557776898983,0,0,1
7,8,14,0,1,0.0,0,0,15,14,France,165,0.3111205255187512,-0.6854474287791303,2,0,2
5,8,0,0,1,0.0,0,0,13,0,US,611,1.2296015562652718,0.13122512192593447,3,3,0
4,8,0,0,1,0.0,0,1,12,0,Germany,173,1.0742771077415625,-0.4623448763238855,3,3,0
47,8,0,10,78,98.0,0,0,55,0,UK,13,-0.22083242349943707,2.243618183739161,0,3,0
5,10,12,6,1,0.0,3,4,15,15,France,15,-0.7518813019708991,-1.4845553601172996,2,0,2
3,8,0,1,1,0.0,0,0,11,0,France,11,1.5932640955765163,-0.20780542456389617,3,3,3
4,8,0,0,1,0.0,0,0,12,0,France,574,1.3419139293825872,0.025257607180264305,3,3,0
48,8,0,19,3,0.0,0,0,56,0,Netherlands,545,0.04385891084012612,1.655387602921363,0,3,0
4,8,0,0,1,0.0,0,0,12,0,France,408,1.3419139293825872,0.025257607180264305,3,3,0
5,8,3,1,6,83.0,0,0,13,3,Italy,11,-0.20375546770528574,0.5663644997013636,0,0,1
17,9,49,0,9,77.0,21,12,26,70,Italy,12,-1.3436614097535642,-0.6863648288265168,1,0,1
3,8,0,0,1,0.0,0,0,11,0,France,709,1.8211872325051166,-0.5087243978983329,3,3,3
22,8,0,27,16,100.0,0,0,30,0,France,653,-0.15880904371690652,2.319746476026743,0,3,0
16,8,33,10,20,79.0,1,0,24,34,France,17,-1.074515365804178,0.4678249898014236,1,0,1
3,8,0,0,3,100.0,0,0,11,0,France,286,1.2152245496785863,0.7713783110470267,3,3,3
6,8,7,4,12,83.0,1,0,14,8,Italy,19,-0.6849798940563703,0.22626055375997808,1,0,1
5,8,1,1,3,66.0,0,0,13,1,Italy,386,-0.1304636233331419,0.56237578219339,0,0,1
40,10,83,0,7,0.0,0,0,50,83,UK,604,-0.7390311734457052,0.12897220329404618,1,0,1
6,10,9,4,3,100.0,1,1,16,10,Italy,13,-1.3483165399089423,-0.07741884693167332,1,0,1
5,8,0,0,1,0.0,0,0,13,0,France,638,1.2296015562652718,0.13122512192593447,3,3,0
5,8,0,0,1,0.0,0,0,13,0,Italy,665,1.2296015562652718,0.13122512192593447,3,3,0
8,8,0,7,8,100.0,0,0,16,0,France,28,0.1432333257838489,1.9973437790818256,0,3,0
4,8,1,0,1,0.0,0,0,12,1,France,595,0.6658324168441598,-0.7877335557206069,2,0,2
12,8,1,10,9,100.0,0,0,20,1,France,19,-0.658881726165064,1.3104228022021718,0,0,1
40,189,68,15,60,90.0,2,0,229,70,Lettonie,11,-2.004406085577779,0.6361637648450484,1,0,1
3,8,0,3,1,0.0,0,0,11,0,UK,114,1.5713360877298872,-0.17885464011350483,3,3,3
40,122,28,18,17,66.0,3,2,162,31,Italy,13,-2.130540651489859,0.05633951830935614,1,0,1
3,8,2,5,1,0.0,3,0,11,5,UK,13,0.5035924651911258,-1.5039884751338135,2,0,3
8,10,70,2,6,100.0,49,8,18,119,Pologne,11,-1.6407831951494134,-0.2716075078630787,1,0,1
4,8,3,0,3,100.0,0,0,12,3,France,14,0.015077961774049277,0.4385708145428739,0,0,1
16,2,91,5,5,80.0,10,1,18,101,Germany,11,-0.9807883555367248,-0.16594042966190176,1,0,1
11,23,334,0,1,0.0,84,2,34,418,France,11,-1.1318839248367838,-1.8662210527321068,1,0,2
4,8,0,1,1,0.0,0,0,12,0,France,618,1.1139907924539865,0.32617658051470094,3,3,0
25,12,30,1,8,87.0,4,28,37,34,France,62,-1.725751205784941,-0.28511113347542427,1,0,1
6,12,112,0,1,0.0,65,9,18,177,France,11,-0.8165586314285145,-2.011514844714201,2,0,2
19,15,82,6,3,66.0,1,7,34,83,US,13,-1.7155575785719306,-0.34674661997067635,1,0,1
8,8,0,1,2,0.0,0,0,16,0,UK,175,0.5491918802892136,1.1372159562194692,0,3,0
3,8,3,0,1,0.0,0,0,11,3,France,132,1.1003139477231099,-1.3755138994810834,2,0,3
6,8,1,0,5,100.0,0,0,14,1,US,25,-0.14399145604195998,0.7024642573641761,0,0,1
7,8,0,0,1,0.0,0,0,15,0,UK,700,1.0955486418094451,0.2577140011050194,3,3,0
11,9,34,11,13,92.0,9,1,20,43,France,14,-1.4729733210845553,-0.23036777382287324,1,0,1
8,10,54,0,1,0.0,4,3,18,58,Italy,44,-0.6851466098833111,-1.7888845488261678,2,0,2
4,8,0,0,2,100.0,0,0,12,0,US,91,0.7515926006932439,1.2746420207833618,0,3,0
15,8,57,55,9,77.0,6,10,23,63,UK,11,-1.4379728411710364,-0.18042406823660176,1,0,1
3,11,21,0,1,0.0,0,0,14,21,Spain,11,0.5141612514741472,-1.3728804235466838,2,0,3
47,94,494,0,4,60.0,56,6,141,550,US,35,-2.0079389184257512,-0.7188837077816852,1,0,1
5,8,13,7,7,87.0,0,0,13,13,Italy,11,-0.31329537105211475,0.5649246120141668,0,0,1
22,8,21,0,10,100.0,0,0,30,21,France,11,-0.6418465819672801,0.918734595039809,0,0,1
8,8,1,0,1,0.0,0,0,16,1,UK,187,0.3736480448097511,-0.5120860575266041,2,0,2
34,147,39,0,6,50.0,49,23,181,88,Slovénie,12,-1.942335567530009,-0.6019020697226587,1,0,1
17,8,6,17,19,100.0,1,0,25,7,Italy,12,-1.1655018606276735,0.9063707867601998,1,0,1
3,8,0,0,1,0.0,0,0,11,0,France,96,1.8211872325051166,-0.5087243978983329,3,3,3
7,10,19,5,2,100.0,109,3,17,128,UK,11,-1.552499511360822,-0.29786138302355186,1,0,1
11,8,5,2,11,100.0,0,0,19,5,Italy,15,-0.6710883697954284,1.1739306711643644,0,0,1
5,8,1,0,2,0.0,0,0,13,1,Italy,236,0.2809055035964815,-0.14637416346417104,2,0,2
5,8,2,0,1,0.0,0,0,13,2,France,25,0.5248746235617312,-0.7161743643349475,2,0,2
3,8,0,0,1,0.0,0,0,11,0,Australia,203,1.8211872325051166,-0.5087243978983329,3,3,3
6,8,1,1,3,100.0,0,0,14,1,Germany,18,-0.3546750811549183,0.9695262889744757,0,0,1
6,8,0,0,1,0.0,0,0,14,0,Spain,191,1.155292251138641,0.2014957695955506,3,3,0
5,8,0,0,1,0.0,0,0,13,0,France,673,1.2296015562652718,0.13122512192593447,3,3,0
6,8,0,0,1,0.0,0,0,14,0,Spain,670,1.155292251138641,0.2014957695955506,3,3,0
4,8,0,0,1,0.0,0,1,12,0,France,254,1.0742771077415625,-0.4623448763238855,3,3,0
6,8,0,3,1,0.0,0,0,14,0,France,284,0.9054411063634108,0.531365527380379,3,3,0
3,9,64,8,2,100.0,408,17,12,472,Germany,11,-0.9959225885616424,-1.1505046764069349,1,0,3
19,8,3,2,12,91.0,0,0,27,3,Italy,11,-0.6395335716256184,1.0129977173687534,0,0,1
52,8,760,18,24,37.0,182,13,60,942,UK,12,-1.9325011616471952,-0.19772434068766173,1,0,1
8,8,0,1,4,50.0,0,0,16,0,Spain,626,0.35955815116556566,1.5561483702133219,0,3,0
9,22,23,0,1,0.0,6,5,31,29,UK,98,-0.9169945956778415,-1.6946232964168266,1,0,2
4,8,0,2,1,0.0,0,0,12,0,France,195,1.1006727729320178,0.3437598974846417,3,3,0
12,8,0,4,19,94.0,0,0,20,0,France,164,0.15008489268352349,1.8376717435832817,0,3,0
3,8,0,0,1,0.0,0,0,11,0,Germany,657,1.8211872325051166,-0.5087243978983329,3,3,3
3,8,9,9,5,60.0,131,3,11,140,Germany,23,-0.4429084949815722,-1.2591176142416876,2,0,3
8,8,3,2,2,100.0,8,1,16,11,France,242,-1.1445642803703993,-0.011590909670892656,1,0,1
6,8,0,0,1,0.0,0,0,14,0,Sweden,672,1.155292251138641,0.2014957695955506,3,3,0
4,8,9,1,4,25.0,1,0,12,10,France,157,-0.43016118814437543,-0.09544380756966347,2,0,1
10,8,5,48,26,95.0,3,1,18,8,Italy,11,-1.2188507589950366,0.021165264690398963,1,0,1
22,9,2,21,23,95.0,112,5,31,114,France,11,-1.6836520420709036,-0.10486284744769395,1,0,1
6,8,0,0,2,0.0,0,0,14,0,UK,377,0.8826777110082775,0.736887647106316,3,3,0
6,8,2,0,1,0.0,0,0,14,2,France,546,0.4505653184351001,-0.645903716665331,2,0,2
4,9,4,8,2,0.0,0,0,13,4,Italy,11,-0.1823339044066434,0.027138601344903247,2,0,1
3,8,1,0,1,0.0,0,0,11,1,Denmark,12,1.1451057199666899,-1.3217155607992042,2,0,3
7,8,16,5,4,75.0,1,0,15,17,Italy,39,-0.744661439985593,0.1714592622632284,1,0,1
14,12,10,2,2,0.0,1,0,26,11,Italy,284,-0.9988390238483095,-0.17165858759238348,1,0,2
3,8,0,0,1,0.0,0,0,11,0,France,328,1.8211872325051166,-0.5087243978983329,3,3,3
9,10,2,1,6,66.0,1,0,19,3,France,13,-0.9739059198516845,0.24701044367557548,1,0,1
4,8,1,0,6,50.0,0,0,12,1,France,297,0.19138443293514293,0.19054994254941612,0,0,1
4,8,2,0,1,0.0,2,0,12,4,France,473,0.2969475948683031,-1.3022528245268412,2,0,2
7,8,0,0,7,85.0,0,0,15,0,Italy,319,0.6048189654610651,1.2712643169244267,0,3,0
6,8,0,23,2,0.0,0,0,14,0,Netherlands,11,0.5833344464920902,1.1321001255174379,0,3,0
4,8,0,0,1,0.0,0,0,12,0,France,617,1.3419139293825872,0.025257607180264305,3,3,0
6,8,1,0,1,0.0,0,0,14,1,France,372,0.4792107386002136,-0.6114953933053205,2,0,2
11,8,98,0,1,0.0,68,17,19,166,Australia,14,-0.6428422259180542,-1.8226324138743417,2,0,2
11,18,7,0,1,0.0,1,5,29,8,France,15,-0.8194562721264561,-1.5757223785289756,1,0,2
9,26,86,1,4,75.0,2,1,35,88,France,254,-1.6739120600193844,-0.4079756120811202,1,0,1
4,8,0,0,1,0.0,0,0,12,0,France,132,1.3419139293825872,0.025257607180264305,3,3,0
4,8,4,0,1,0.0,1,0,12,5,Ireland,146,0.2879300882493906,-1.3105423343156264,2,0,2
6,8,0,0,3,66.0,0,0,14,0,Ireland,334,0.6992317210072555,1.1447186194294403,0,3,0
3,8,0,0,1,0.0,0,0,11,0,France,378,1.8211872325051166,-0.5087243978983329,3,3,3
3,8,0,0,2,100.0,0,0,11,0,France,16,1.2308659038157737,0.7406600157047639,3,3,3
3,8,0,4,1,0.0,0,0,11,0,France,68,1.564006712331706,-0.16917792124360725,3,3,3
6,9,121,1,1,0.0,2,2,15,123,Luxembourg,33,-0.782874729106607,-1.59010932019219,2,0,2
6,8,1,0,2,0.0,0,0,14,1,France,379,0.20659619846985028,-0.07610351579455481,2,0,2
8,8,1,2,2,100.0,0,0,16,1,Italy,297,-0.45791444033016204,1.0558006463808705,0,0,1
4,8,0,0,3,0.0,0,0,12,0,Spain,330,1.0536580351150366,0.5913677800332926,3,3,0
3,8,0,0,1,0.0,0,0,11,0,France,376,1.8211872325051166,-0.5087243978983329,3,3,3
5,8,31,0,1,0.0,1,1,13,32,France,22,-0.17784417271498051,-1.7952911024449556,2,0,2
6,8,0,0,1,0.0,0,0,14,0,Netherlands,626,1.155292251138641,0.2014957695955506,3,3,0
5,8,3,6,2,0.0,1,0,13,4,Italy,11,-0.3522519294306217,-0.30469693227760813,2,0,1
9,8,1,1,2,66.0,0,0,17,1,France,31,-0.3292875497010907,0.7340654989507217,0,0,1
4,8,0,0,1,0.0,3,2,12,3,UK,646,0.36346559863169325,-1.4076411713979655,2,0,2
4,8,0,0,1,0.0,0,0,12,0,France,44,1.3419139293825872,0.025257607180264305,3,3,0
8,8,0,0,1,0.0,0,0,16,0,Italy,45,1.0497295573481782,0.3009051053742669,3,3,0
13,8,0,0,4,50.0,0,0,21,0,Italy,624,0.4534359206062776,1.3815886791625394,0,3,0
11,8,19,2,2,0.0,26,0,19,45,Portugal,66,-0.7449407635427968,-0.27328620255811126,1,0,1
4,8,2,1,2,0.0,0,0,12,2,Netherlands,411,0.13664931962008162,0.014168971764585161,2,0,1
22,11,22,6,11,81.0,2,0,33,24,Italy,20,-1.3631354371701034,0.38896424332394114,1,0,1
4,8,0,0,1,0.0,0,0,12,0,France,700,1.3419139293825872,0.025257607180264305,3,3,0
5,8,0,0,1,0.0,0,0,13,0,UK,672,1.2296015562652718,0.13122512192593447,3,3,0
4,8,0,0,1,0.0,0,0,12,0,Italy,16,1.3419139293825872,0.025257607180264305,3,3,0
5,8,11,4,4,100.0,0,0,13,11,UK,34,-0.41694287793063994,0.8402665751321312,0,0,1
7,8,262,0,1,0.0,312,9,15,574,France,40,-0.5917409467483137,-2.0516312398644647,2,0,2
5,5,34,0,3,66.0,5,5,10,39,France,16,-0.021601485723163522,-1.144324557542872,2,0,2
11,9,0,1,9,88.0,0,0,20,0,Spain,147,0.04946317504274367,1.6538989082088296,0,3,0
4,9,0,0,2,0.0,0,0,13,0,France,683,0.8242630987750191,0.5476229316036949,3,3,0
6,8,0,0,1,0.0,0,0,14,0,France,184,1.155292251138641,0.2014957695955506,3,3,0
22,9,8,1,20,80.0,10,0,31,18,France,11,-1.2491599951021102,0.3976518349800745,1,0,1
4,8,1,0,1,0.0,0,0,12,1,France,275,0.6658324168441598,-0.7877335557206069,2,0,2
9,8,0,7,6,33.0,1,0,17,1,France,12,-0.3893047265535353,0.7904807753328942,0,0,1
4,8,0,0,2,0.0,0,0,12,0,France,139,1.0692993892522238,0.5606494846910302,3,3,0
6,8,0,0,1,0.0,0,0,14,0,France,395,1.155292251138641,0.2014957695955506,3,3,0
7,8,688,0,1,0.0,2,2,15,690,France,11,-0.5085495661925017,-1.9145188984705546,2,0,2
26,8,0,0,2,0.0,0,0,34,0,US,626,0.49208458978764996,1.1047935925677037,0,3,0
5,8,0,0,2,0.0,0,0,13,0,UK,220,0.9569870161349087,0.6666169994366998,3,3,0
4,9,0,1,1,0.0,1,0,13,1,France,446,0.20756687726628148,-0.5614779048075167,2,0,1
3,8,1,0,1,0.0,0,0,11,1,UK,639,1.1451057199666899,-1.3217155607992042,2,0,3
4,8,1,0,2,100.0,0,0,12,1,France,656,0.07551108815481665,0.4616508578824904,0,0,1
4,3,1,0,2,100.0,0,0,7,1,US,233,0.7325633976249027,0.30630733526042314,0,0,2
3,8,0,0,2,100.0,0,0,11,0,France,15,1.2308659038157737,0.7406600157047639,3,3,3
9,8,0,5,10,100.0,0,0,17,0,France,26,0.10874441784168318,2.0349774594664916,0,3,0
4,8,0,1,1,0.0,0,0,12,0,France,651,1.1139907924539865,0.32617658051470094,3,3,0
3,8,5,0,1,0.0,0,0,11,5,Spain,11,1.0792216463891189,-1.4008440392390669,2,0,3
3,8,3,0,1,0.0,0,0,11,3,France,36,1.1003139477231099,-1.3755138994810834,2,0,3
4,8,27,0,1,0.0,18,10,12,45,US,372,-0.1610345303695303,-2.0524483710665824,2,0,2
5,10,16,0,1,0.0,1,2,15,17,Germany,154,-0.4669994930559955,-1.802168928478317,2,0,2
4,8,0,1,3,66.0,1,1,12,1,France,37,-0.27109418402892416,-0.09283098539044178,1,0,1
4,8,0,1,1,0.0,0,0,12,0,France,131,1.1139907924539865,0.32617658051470094,3,3,0
8,8,3,2,5,83.0,2,1,16,5,Swiss,16,-0.99657796487018,-0.21943893966997763,1,0,1
6,8,1,0,2,100.0,2,2,14,3,Austria,60,-0.7385995124654894,-0.36071761103409067,1,0,1
67,30,345,4,42,79.0,157,12,97,502,Bulgaria,11,-2.2860706014766703,-0.2294724645067186,1,0,1
44,90,105,4,19,94.0,7,1,134,112,Italy,11,-2.158184431006544,-0.037919462196530064,1,0,1
6,8,0,0,3,66.0,0,0,14,0,France,26,0.6992317210072555,1.1447186194294403,0,3,0
5,8,12,0,9,60.0,1,0,13,13,France,68,-0.35469876103689296,-0.24795790571378298,2,0,1
19,9,21,3,6,83.3,1,7,28,22,France,27,-1.4961018292973962,-0.20496423102356456,1,0,1
16,9,0,4,12,91.0,12,279,25,12,France,11,-1.2023006018241442,0.11857825338444898,1,0,1
9,8,3,1,1,0.0,4,0,17,7,Denmark,54,-0.2882441924740914,-0.7320476539705741,2,0,2
3,8,2,1,1,0.0,0,3,11,2,France,13,0.6024944248453492,-1.5763407866560641,2,0,3
4,8,9,2,2,0.0,1,2,12,10,Germany,105,-0.5347973026937379,-1.0007691168376396,2,0,1
3,8,1,0,2,0.0,2,1,11,3,Denmark,25,0.25637963129949615,-1.7642020915533376,2,0,3
6,9,221,2,2,0.0,1,6,15,222,Spain,11,-1.115743750400937,-1.1042389581253345,1,0,1
13,10,3,2,1,0.0,0,0,23,3,Spain,11,-0.2823615666870272,-0.2042584212879413,2,0,2
9,8,2,4,2,50.0,18,1,17,20,Italy,16,-1.0644503186562122,-0.3350142916547149,1,0,1
7,8,0,0,2,100.0,0,0,15,0,France,25,0.5052273131201019,1.5070984147081161,0,3,0
3,8,0,0,1,0.0,0,0,11,0,Italy,665,1.8211872325051166,-0.5087243978983329,3,3,3
7,8,14,4,3,100.0,1,0,15,15,UK,17,-0.8702520747785325,0.48313892338109066,1,0,1
6,8,9,0,2,0.0,9,0,14,18,UK,306,-0.24909045526041748,-0.7000841974074222,2,0,2
52,3,137,0,30,90.0,117,80,55,254,Luxembourg,11,-1.288175585271911,-0.35333774313350347,1,0,1
5,8,0,0,1,0.0,0,0,13,0,France,649,1.2296015562652718,0.13122512192593447,3,3,0
11,9,3,0,1,0.0,0,0,20,3,France,568,0.056586453282764286,-0.54617301054278,2,0,2
4,8,1,3,1,0.0,0,0,12,1,Italy,44,0.41598127206893,-0.4578637979357786,2,0,2
4,8,0,0,1,0.0,0,0,12,0,US,251,1.3419139293825872,0.025257607180264305,3,3,0
3,9,5,0,1,0.0,0,0,12,5,France,319,0.7824725425319039,-1.3711167076063187,2,0,3
3,8,2,0,2,100.0,11,1,11,13,UK,29,-0.13345514989558876,-1.1433561484272163,2,0,3
5,8,11,0,2,100.0,4,15,13,15,UK,88,-0.7945042922106558,-0.6120277730064339,1,0,1
4,9,43,1,2,100.0,0,2,13,43,Singapour,13,-0.841751872034365,0.04253832271271978,1,0,1
3,8,0,1,1,0.0,0,0,11,0,France,588,1.5932640955765163,-0.20780542456389617,3,3,3
5,9,1,0,1,0.0,2,0,14,3,UK,440,-0.012808205913317421,-1.2075420382868103,2,0,2
10,8,6,0,1,0.0,5,1,18,11,US,259,-0.3833509287165155,-1.5269116078617606,2,0,2
3,8,0,0,1,0.0,0,0,11,0,US,173,1.8211872325051166,-0.5087243978983329,3,3,3
10,11,85,1,8,25.0,104,1,21,189,Italy,23,-1.5695452101230993,-0.5426881707579587,1,0,1
15,10,1,0,1,0.0,0,0,25,1,US,634,-0.024309731537100667,-0.4421592096910802,2,0,2
8,10,42,0,1,0.0,17,2,18,59,US,54,-0.699594727960596,-1.8077995239881393,2,0,2
7,15,0,0,1,0.0,14,0,22,14,US,30,-0.08760282693725045,-0.7660169088993339,2,0,2
28,11,2942,6,1,0.0,135,67,39,3077,Australia,11,-1.618393077718416,-1.667932038467393,1,0,2
11,8,0,2,3,33.0,0,0,19,0,Spain,17,0.26778837566945646,1.6353582939553495,0,3,0
15,8,3,2,10,90.0,0,0,23,3,Italy,11,-0.5825470568285672,0.950781446833424,0,0,1
3,8,121,0,1,0.0,0,0,11,121,France,58,0.9260961581374982,-1.5848643028081675,2,0,3
7,1,5,1,7,100.0,13,1,8,18,UK,24,-0.3238279021966646,-0.30884491495288635,0,0,2
4,9,0,0,1,0.0,0,13,13,0,France,210,0.7837726481759484,-0.5582090301268345,3,3,0
4,8,0,1,3,100.0,0,0,12,0,France,46,0.5080281096274553,1.606279289460061,0,3,0
6,8,0,0,4,100.0,0,0,14,0,Swiss,354,0.5394343716023219,1.5010318071603546,0,3,0
16,8,30,5,24,84.0,71,1,24,101,UK,11,-1.4277888436735215,-0.1527228535196896,1,0,1
3,8,0,1,1,0.0,3,0,11,3,France,43,0.8938299603061759,-1.1323734965710073,2,0,3
10,8,0,2,4,100.0,0,0,18,0,Luxembourg,13,0.12965504485786375,1.9783299171451736,0,3,0
3,8,1,0,1,0.0,0,0,11,1,France,569,1.1451057199666899,-1.3217155607992042,2,0,3
12,12,196,0,3,100.0,69,58,24,265,US,12,-1.6382394150465798,-0.6920267689891232,1,0,1
6,8,0,1,1,0.0,0,0,14,0,UK,209,0.9273691142100399,0.5024147429299874,3,3,0
3,8,1,0,1,0.0,0,0,11,1,France,686,1.1451057199666899,-1.3217155607992042,2,0,3
25,8,0,1,1,0.0,0,0,33,0,Germany,170,0.5466053342139872,0.8608333859973111,3,3,0
8,11,2,0,1,0.0,0,0,19,2,UK,693,0.03987513129461837,-0.6075711313675407,2,0,2
3,9,0,0,1,0.0,2,0,12,2,France,48,0.8388040420021293,-1.3854336018288242,2,0,3
26,8,1,2,2,100.0,0,0,34,1,France,28,-0.7429448677603266,1.3242972560635413,0,0,1
5,8,0,2,4,75.0,0,0,13,0,Austria,45,0.5193930373350232,1.4191517349120881,0,3,0
11,8,28,5,5,100.0,67,2,19,95,Portugal,30,-1.4375029943409385,-0.029101490763292586,1,0,1
15,8,3,1,5,80.0,0,0,23,3,UK,11,-0.5426187012708891,0.8793399507358015,0,0,1
4,8,0,7,2,100.0,0,0,12,0,Spain,11,0.48143579338096093,1.6313206370538451,0,3,0
7,8,164,0,1,0.0,30,10,15,194,Netherlands,18,-0.5061545018250087,-1.9400864813976246,2,0,2
8,8,162,0,1,0.0,4,4,16,166,Romania,11,-0.4934633999588024,-1.808004578973599,2,0,2
10,8,6,0,5,100.0,0,0,18,6,Italy,17,-0.38578706798027135,0.7732749680225822,0,0,1
5,8,1,0,2,0.0,0,0,13,1,Germany,257,0.2809055035964815,-0.14637416346417104,2,0,2
9,8,0,2,10,83.0,0,0,17,0,UK,32,0.2732169826744135,1.6847988033703774,0,3,0
3,8,0,4,4,75.0,0,0,11,0,France,11,1.095039349852027,0.8002464014381693,3,3,3
14,8,0,3,27,100.0,0,0,22,0,UK,62,-0.026073280889719403,2.1899402495760296,0,3,0
3,8,0,0,1,0.0,0,0,11,0,Italy,709,1.8211872325051166,-0.5087243978983329,3,3,3
3,8,28,1,2,100.0,1,1,11,29,Spain,11,-0.3991534026146662,-0.878505030857152,2,0,3
4,8,0,3,1,0.0,0,1,12,0,France,125,0.8244259629663331,-0.1324751185390574,3,3,0
5,8,0,1,5,100.0,0,0,13,0,Italy,137,0.37847622469449715,1.7461037459298678,0,3,0
13,8,2,10,1,0.0,0,0,21,2,Estonie,11,-0.06772769069499872,-0.05219707562998315,2,0,2
7,8,0,2,1,0.0,0,0,15,0,Grèce,30,0.8543074853588755,0.5762162914093966,3,3,0
4,8,0,0,1,0.0,0,0,12,0,France,40,1.3419139293825872,0.025257607180264305,3,3,0
9,8,5,10,12,100.0,1,1,17,6,UK,11,-1.2444289985765682,0.23769735278391704,1,0,1
28,8,4,0,47,77.0,8,1,36,12,UK,21,-1.1709508628716239,-0.18287732625170322,1,0,1
3,8,0,0,1,0.0,0,0,11,0,France,685,1.8211872325051166,-0.5087243978983329,3,3,3
20,8,11,12,30,93.0,0,1,28,11,Italy,12,-1.0421284576628806,0.5869444611270517,1,0,1
4,8,0,2,2,100.0,0,0,12,0,France,119,0.5103514442426742,1.5931443110877386,0,3,0
11,9,20,1,8,62.0,1,1,20,21,Bulgaria,49,-1.3223013286611442,-0.2805405993716092,1,0,1
6,12,52,2,1,0.0,446,8,18,498,Italy,11,-1.1071078325392123,-1.7616080041751263,1,0,2
6,8,1,0,2,100.0,0,0,14,1,Italy,225,-0.11111059008912956,0.6378890202977765,0,0,1
6,8,69,6,2,100.0,8,4,14,77,Singapour,11,-1.2078721868044056,-0.2651047133218652,1,0,1
5,9,1,3,1,0.0,1,0,14,2,Italy,181,-0.2446081542614093,-0.8535105818298117,2,0,2
4,8,2,0,1,0.0,5,5,12,7,UK,11,-0.02459128581007302,-1.8756820913591103,2,0,2
13,8,40,14,8,62.0,0,0,21,40,Italy,198,-0.6933423636075983,0.7986340587306952,0,0,1
8,8,50,2,9,100.0,1,0,16,51,Italy,11,-0.9964810027450219,0.49857944050577097,1,0,1
3,8,1,0,1,0.0,0,0,11,1,France,226,1.1451057199666899,-1.3217155607992042,2,0,3
3,8,0,0,1,0.0,0,0,11,0,UK,655,1.8211872325051166,-0.5087243978983329,3,3,3
6,10,9,1,1,0.0,2,0,16,11,UK,39,-0.45818508372719624,-0.9261346067264862,2,0,2
6,8,0,0,1,0.0,0,0,14,0,France,533,1.155292251138641,0.2014957695955506,3,3,0
3,8,0,0,1,0.0,0,0,11,0,France,701,1.8211872325051166,-0.5087243978983329,3,3,3
31,27,161,4,24,100.0,612,20,58,773,Bulgaria,11,-2.334443071346193,-0.09932804736356902,1,0,1
9,9,15,11,8,85.7,3,0,18,18,France,100,-1.0718697574107645,0.24067738729256027,1,0,1
18,16,52,0,18,100.0,4,48,34,56,Spain,12,-1.6974821829542686,-0.3267329898283647,1,0,1
12,8,0,6,6,33.0,0,0,20,0,UK,11,0.19724910864146256,1.7338876170434712,0,3,0
7,8,2,0,1,0.0,0,0,15,2,Croatie,500,0.39082170910590414,-0.5896854851558625,2,0,2
12,8,5,0,1,0.0,0,0,20,5,France,44,0.19435754821627074,-0.484453798211523,2,0,2
34,8,6,7,11,83.0,0,0,42,6,Croatie,12,-0.8260315115314149,1.1274485016566254,0,0,1
4,8,1,1,3,33.0,0,0,12,1,France,84,-0.01289237901053549,0.44458983950074565,0,0,1
19,9,13,35,23,82.0,1,0,28,14,France,11,-1.2709470441486723,0.5302351073399901,1,0,1
4,9,0,1,2,66.0,0,0,13,0,France,11,0.4285353259825833,1.2256545819189937,0,3,0
15,8,0,10,38,84.0,1,0,23,1,France,11,-0.599899645392322,1.068763324795139,0,0,1
131,10,14,122,152,92.0,7,0,141,21,US,12,-1.8389238380005561,1.0072208418650952,1,0,1
13,9,1,0,1,0.0,1,1,22,2,Estonie,516,-0.5353539276245222,-1.4088052307638415,2,0,2
4,8,0,0,1,0.0,0,0,12,0,France,573,1.3419139293825872,0.025257607180264305,3,3,0
9,9,3,1,2,100.0,0,0,18,3,US,256,-0.7101786519500628,0.9554748696419844,0,0,1
4,8,1,0,1,0.0,0,0,12,1,France,367,0.6658324168441598,-0.7877335557206069,2,0,2
5,8,1,10,11,90.0,0,0,13,1,Spain,71,-0.23372554133919196,0.7355473153128229,0,0,1
121,0,1140,31,108,94.0,531,105,121,1671,Sweden,11,-1.5124512669078154,0.261244753188073,1,2,2
7,13,357,3,3,100.0,6,24,20,363,France,11,-1.775379549761394,-0.4036045645537971,1,0,1
6,8,3,1,1,0.0,47,13,14,50,France,13,-0.5498240993142511,-1.5515547182763962,2,0,2
4,8,4,0,1,0.0,3,0,12,7,France,12,0.26484712599710275,-1.3420127528021655,2,0,2
13,8,11,9,10,70.0,0,0,21,11,Italy,18,-0.630049090903456,0.8839629562735001,0,0,1
7,8,1,16,2,100.0,0,0,15,1,US,12,-0.45908432296915064,1.0746474375547865,0,0,1
6,12,16,3,1,0.0,214,8,18,230,US,11,-1.0489719500824863,-1.6667232420402072,1,0,2
12,8,0,3,10,90.0,0,0,20,0,UK,13,0.18144904205120194,1.7799632111390933,0,3,0
15,15,22,1,2,0.0,2,4,30,24,UK,424,-1.3851228339234833,-0.7634262425630856,1,0,1
5,8,0,0,2,0.0,0,0,13,0,France,187,0.9569870161349087,0.6666169994366998,3,3,0
5,8,0,0,1,0.0,0,0,13,0,Spain,625,1.2296015562652718,0.13122512192593447,3,3,0
8,8,0,0,1,0.0,0,3,16,0,US,31,0.7636868193205524,-0.22023077045701975,3,3,0
11,8,6,19,2,100.0,1,2,19,7,US,371,-1.2712155285714317,0.15908706773069844,1,0,1
6,8,0,2,1,0.0,0,0,14,0,US,94,0.9140510946880713,0.5199980598999281,3,3,0
10,8,0,4,1,0.0,0,0,18,0,Italy,621,0.7295735606713418,0.6998380659307177,3,3,0
6,8,15,2,1,0.0,15,1,14,30,Islande,11,-0.5205210876569181,-1.4493747679199187,2,0,2
5,9,32,2,2,100.0,2,5,14,34,Germany,424,-1.2689993689182955,-0.33292562625049504,1,0,1
14,10,41,1,2,100.0,0,0,24,41,Italy,469,-0.9926690979307355,0.9004064095671249,0,0,1
14,12,10,2,2,100.0,0,0,26,10,Italy,26,-0.9976433123432746,0.9942276022934838,0,0,1
11,8,48,2,4,100.0,4,11,19,52,Netherlands,14,-1.3932203286557892,-0.06064094309441636,1,0,1
5,8,0,2,2,0.0,0,0,13,0,France,15,0.7157458596843389,0.9851192897410775,3,3,0
8,8,6,1,5,100.0,0,0,16,6,Netherlands,13,-0.5507347284054468,1.014807457455294,0,0,1
4,8,0,1,1,0.0,0,1,12,0,France,348,0.8463539708129616,-0.16142590298944873,3,3,0
7,9,141,2,5,100.0,171,9,16,312,Austria,11,-1.6046279467105775,-0.40773885096270873,1,0,1
24,8,0,27,13,69.0,0,0,32,0,France,11,-0.02729083724953223,1.995311079434092,0,3,0
5,9,0,8,3,100.0,0,0,14,0,Spain,32,0.13233226886217056,1.736858330946347,0,3,0
7,8,38,3,4,0.0,14,0,15,52,France,40,-0.6542371440145882,-0.34993334951378036,1,0,1
3,8,0,0,1,0.0,0,0,11,0,Netherlands,68,1.8211872325051166,-0.5087243978983329,3,3,3
5,8,86,0,1,0.0,4,2,13,90,UK,14,-0.26523882448181635,-1.9118970888860618,2,0,2
6,8,0,1,1,0.0,0,0,14,0,US,251,0.9273691142100399,0.5024147429299874,3,3,0
5,8,3,0,1,0.0,0,1,13,3,US,561,0.24109144984224037,-1.2231668631609658,2,0,2
8,12,30,1,2,0.0,2,0,20,32,UK,13,-0.9393633098123901,-0.37108581788233436,1,0,2
4,8,0,0,1,0.0,0,0,12,0,France,590,1.3419139293825872,0.025257607180264305,3,3,0
4,8,3,0,1,0.0,0,0,12,3,France,400,0.6210406446005802,-0.8415318944024858,2,0,2
12,9,14,13,7,85.0,0,0,21,14,Italy,15,-0.8039373973530909,0.7876116608842003,0,0,1
19,12,4,12,13,92.3,2,1,31,6,France,12,-1.58785018027587,0.002396348666675005,1,0,1
6,8,0,0,1,0.0,0,0,14,0,Estonie,384,1.155292251138641,0.2014957695955506,3,3,0
23,8,1,15,22,95.0,0,0,31,1,Spain,12,-0.701916294477419,1.2063405080866774,0,0,1
9,8,0,1,1,0.0,0,0,17,0,France,325,0.7872131388315342,0.6345521073599655,3,3,0
6,8,0,0,3,66.0,0,0,14,0,France,274,0.6992317210072555,1.1447186194294403,0,3,0
5,9,109,3,1,0.0,8,8,14,117,Germany,14,-0.7813107060480778,-1.6938464238419177,2,0,2
10,24,342,7,3,66.0,425,10,34,767,Italy,11,-1.9415396814376105,-0.7079921571585334,1,0,1
8,8,0,0,1,0.0,0,0,16,0,Italy,688,1.0497295573481782,0.3009051053742669,3,3,0
4,8,4,1,1,0.0,0,0,12,4,Germany,44,0.3808468711045377,-0.5553383223702686,2,0,2
4,9,0,0,2,0.0,0,0,13,0,France,647,0.8242630987750191,0.5476229316036949,3,3,0
6,9,2,3,1,0.0,2,1,15,4,Netherlands,19,-0.6155345753412195,-1.3270859327955844,2,0,2
3,8,59,0,1,0.0,29,0,11,88,UK,12,0.5833956798629213,-2.077722169568363,2,0,3
7,8,0,2,9,90.0,0,0,15,0,UK,94,0.3530212663124065,1.6113052832883703,0,3,0
4,8,4,8,2,50.0,4,0,12,8,UK,35,-0.4533458108904269,-0.08761433143399698,1,0,1
9,8,0,0,3,100.0,0,0,17,0,US,610,0.4091735929336051,1.6137358429708881,0,3,0
4,8,0,0,1,0.0,0,0,12,0,US,44,1.3419139293825872,0.025257607180264305,3,3,0
15,8,9,14,27,74.0,0,0,23,9,Slovaquie,15,-0.6963403023640681,0.9999421887332269,0,0,1
4,8,1,0,1,0.0,1,0,12,2,France,16,0.33540888637549215,-1.2538477818091853,2,0,2
19,8,0,1,19,50.0,0,0,27,0,Belgium,462,0.09625743236110047,1.8546394766335395,0,3,0
4,8,0,0,1,0.0,0,2,12,0,France,11,1.062899733902033,-0.48307309939085447,3,3,0
4,8,0,0,1,0.0,0,0,12,0,Belgium,205,1.3419139293825872,0.025257607180264305,3,3,0
22,14,185,0,5,100.0,37,53,36,222,Luxembourg,12,-1.7861687359476173,-0.5241766747542038,1,0,1
3,8,0,0,1,0.0,0,0,11,0,France,519,1.8211872325051166,-0.5087243978983329,3,3,3
60,9,41,244,70,88.0,37,14,69,78,France,11,-2.138488897337357,0.28065714523807417,1,0,1
4,8,3,4,4,80.0,0,0,12,3,Germany,61,-0.10720817193710376,0.4721604002449197,0,0,1
4,8,0,2,1,0.0,0,0,12,0,France,406,1.1006727729320178,0.3437598974846417,3,3,0
10,8,0,0,3,100.0,0,0,18,0,France,13,0.3807913980182218,1.6403942982213513,0,3,0
14,8,0,0,1,0.0,0,0,22,0,France,691,0.8998684948968757,0.44224242958074517,3,3,0
13,8,0,1,6,100.0,0,0,21,0,Italy,11,0.05970345874036281,2.0516786053225666,0,3,0
6,8,11,0,3,66.0,1,0,14,12,France,48,-0.39282464805363937,-0.23678141248670215,2,0,1
3,8,0,0,1,0.0,0,0,11,0,Germany,385,1.8211872325051166,-0.5087243978983329,3,3,3
6,8,4,5,7,85.0,0,0,14,4,France,14,-0.33079807591111204,0.6797267906240146,0,0,1
5,15,420,0,1,0.0,5,0,20,425,France,11,-0.5730812388691736,-1.480132853065379,2,0,2
4,8,0,0,1,0.0,0,0,12,0,France,68,1.3419139293825872,0.025257607180264305,3,3,0
9,17,3,3,8,100.0,0,0,26,3,Italy,12,-1.0125768233996113,1.0928740239535446,0,0,1
5,5,15,1,1,0.0,0,5,10,15,Romania,40,0.592222876082659,-1.2490653222753498,2,0,2
42,8,0,5,29,86.0,0,0,50,0,UK,15,-0.139877333887611,2.12106626301239,0,3,0
5,8,0,2,1,0.0,0,0,13,0,France,691,0.9883603998147025,0.4497274122303117,3,3,0
7,8,0,2,2,0.0,46,0,15,46,France,595,-0.22556386802193057,0.045616586110513585,2,0,1
14,12,19,1,3,100.0,9,0,26,28,France,219,-1.3890734228414459,0.4634660383920665,1,0,1
7,8,4,6,8,100.0,0,0,15,4,Italy,13,-0.5401121591919676,1.0673839722996206,0,0,1
21,9,0,0,13,100.0,9,3,30,9,Germany,390,-1.0358952508761576,0.32467295341562535,1,0,1
3,8,19,0,1,0.0,0,0,11,19,Italy,52,1.022855355689288,-1.4686481914360257,2,0,3
30,60,1209,0,3,100.0,919,9,90,2128,Singapour,11,-2.197847614675425,-0.6680455513073299,1,0,1
3,8,1,0,1,0.0,0,0,11,1,France,701,1.1451057199666899,-1.3217155607992042,2,0,3
4,8,0,0,1,0.0,0,0,12,0,France,259,1.3419139293825872,0.025257607180264305,3,3,0
4,8,3,0,1,0.0,0,1,12,3,Germany,324,0.3534038229595553,-1.3291343779066356,2,0,2
7,8,0,1,1,0.0,0,0,15,0,Spain,641,0.8676255048808439,0.5586329744394559,3,3,0
6,8,21,3,1,0.0,5,0,14,26,Germany,165,-0.2445608263359893,-0.9252009239791822,2,0,2
15,10,136,9,4,50.0,13,5,25,149,UK,22,-1.6449501951225665,-0.4442330416811929,1,0,1
12,9,0,0,5,60.0,0,0,21,0,UK,426,0.28481059378487705,1.3137642180501752,0,3,0
7,8,2,11,13,84.0,0,0,15,2,Italy,11,-0.40202694171260167,0.8360157384418585,0,0,1
59,108,1,2,7,71.0,0,0,167,1,Italy,11,-1.3284189912334052,1.132995580556948,1,0,1
10,8,226,1,3,100.0,185,25,18,411,France,11,-1.528385176020052,-0.37070174004792084,1,0,1
5,8,2,1,4,75.0,0,0,13,2,Spain,29,-0.1720158758465493,0.5541689316812659,0,0,1
4,8,0,0,1,0.0,0,0,12,0,France,617,1.3419139293825872,0.025257607180264305,3,3,0
14,10,25,1,2,0.0,47,1,24,72,Lituanie,471,-1.3212340115351304,-0.8390514362762328,1,0,1
8,11,40,0,1,0.0,58,3,19,98,France,53,-0.7819264929653827,-1.8560033484499887,2,0,2
5,8,0,0,2,50.0,29,0,13,29,Italy,280,0.004106656813506761,-0.006716574530173434,0,0,1
10,8,0,1,4,75.0,0,0,18,0,Italy,204,0.2898635814364722,1.6306348852922057,0,3,0
6,8,0,0,1,0.0,0,0,14,0,France,41,1.155292251138641,0.2014957695955506,3,3,0
12,8,1,0,11,75.0,0,0,20,1,Italy,194,-0.24058067942449932,0.6266594057819768,0,0,1
15,8,1,17,26,88.0,0,0,23,1,Spain,20,-0.6152303124529325,1.1251826490611365,0,0,1
6,10,0,0,1,0.0,0,0,16,0,France,687,0.8663048247468618,0.16212463623431905,3,3,0
4,8,1,0,3,0.0,0,0,12,1,Canada,17,0.3775765225766092,-0.22162338286757852,2,0,2
4,8,4,0,1,0.0,0,1,12,4,Germany,525,0.34113318639211443,-1.3438597792088554,2,0,2
6,8,0,0,1,0.0,0,1,14,0,Italy,57,0.8876554294976163,-0.2861067139085992,3,3,0
12,8,3,15,19,94.0,0,0,20,3,Italy,11,-0.601042084940024,1.0108251381546136,0,0,1
7,8,0,0,1,0.0,0,0,15,0,Italy,673,1.0955486418094451,0.2577140011050194,3,3,0
8,9,1,2,4,100.0,0,0,17,1,France,18,-0.6734953628044772,1.0474608120340505,0,0,1
8,8,0,0,1,0.0,0,1,16,0,Spain,442,0.7820927357071538,-0.18669737812988288,3,3,0
5,8,9,0,1,0.0,0,0,13,9,France,231,0.46367640414817485,-0.7896888287292272,2,0,2
6,8,0,0,2,0.0,0,0,14,0,France,397,0.8826777110082775,0.736887647106316,3,3,0
10,9,2,1,7,100.0,24,4,19,26,France,12,-1.4797148352446228,-0.03825014498660538,1,0,1
20,8,106,1,4,75.0,0,2,28,106,Germany,44,-1.037615251773258,0.20571765812248496,1,0,1
8,8,25,0,1,0.0,4,3,16,29,Croatie,29,-0.38927743382887575,-1.6795920490827676,2,0,2
30,37,27,1,5,100.0,3,2,67,30,Spain,218,-2.008126213043224,0.16204782183305805,1,0,1
12,8,15,1,1,0.0,69,2,20,84,France,224,-0.7871178345665432,-1.3469996422181518,2,0,2
6,8,0,0,3,100.0,0,0,14,0,US,183,0.5493295683121103,1.4815984785409098,0,3,0
10,18,5,0,1,0.0,3,2,28,8,Germany,38,-0.7974918102170149,-1.5742548426037233,2,0,2
10,16,2,1,2,100.0,1,0,26,3,Germany,28,-1.2532489008680365,0.5479084091493863,1,0,1
3,8,117,1,1,0.0,2,0,11,119,Italy,12,0.3735430506424148,-1.744881156130105,2,0,3
15,9,3,11,12,91.0,5,0,24,8,Italy,20,-1.1683289949368223,0.4419826522410107,1,0,1
4,8,1,0,1,0.0,10,1,12,11,US,392,-0.001909672258987219,-1.8340146820056118,2,0,2
8,9,2,14,11,100.0,0,0,17,2,Italy,11,-0.7794661484457154,1.135645911077403,0,0,1
8,8,0,0,5,80.0,0,0,16,0,France,212,0.5713169458780506,1.28947453647164,0,3,0
23,8,165,4,21,80.0,0,1,31,165,France,13,-1.1682676179482985,0.37013112445894214,1,0,1
4,8,0,0,2,100.0,1,0,12,1,Netherlands,631,0.090204975982744,0.40001408854847864,0,0,1
22,20,20,5,6,100.0,0,0,42,20,US,12,-1.2773805202637825,1.1527208872407018,1,0,1
5,8,3,10,7,100.0,0,0,13,3,Italy,14,-0.402684240781947,0.9650403138071147,0,0,1
24,23,34,46,34,85.0,9,1,47,43,Italy,11,-1.9312585701678102,0.0012332047613304144,1,0,1
3,8,0,0,1,0.0,0,0,11,0,France,313,1.8211872325051166,-0.5087243978983329,3,3,3
4,10,126,4,2,100.0,32,2,14,158,Italy,11,-1.409063124007098,-0.5061122290119422,1,0,1
7,8,0,9,4,66.6,0,0,15,0,Italy,12,0.35194209920903186,1.5881589877053062,0,3,0
12,7,30,1,1,0.0,0,1,19,30,Italy,34,-0.09622021953225424,-0.6533917321975428,2,0,2
4,8,1,0,1,0.0,1,0,12,2,UK,200,0.33540888637549215,-1.2538477818091853,2,0,2
3,8,1,0,1,0.0,1,0,11,2,UK,293,0.814682189498022,-1.7878297868877828,2,0,3
4,9,16,0,1,0.0,15,1,13,31,France,37,-0.3401798584584069,-1.9600963134137912,2,0,2
3,0,0,0,1,0.0,0,0,3,0,France,44,3.2755774739096957,-0.7662209916491922,3,1,2
4,8,4,0,1,0.0,0,0,12,4,Portugal,14,0.6087700080331391,-0.8562572957047054,2,0,2
3,8,0,0,1,0.0,0,0,11,0,Italy,664,1.8211872325051166,-0.5087243978983329,3,3,3
18,9,19,84,29,66.0,15,0,27,34,Italy,11,-1.3598143658756225,0.4491933668009821,1,0,1
4,8,0,0,2,100.0,0,0,12,0,France,376,0.7515926006932439,1.2746420207833618,0,3,0
13,8,1,4,4,75.0,0,0,21,1,UK,14,-0.48654520533122864,0.923244024093553,0,0,1
12,5,1,4,6,33.0,12,1,17,13,France,11,-0.8104315435784591,-0.06305401893966228,1,0,1
3,9,2,0,1,0.0,0,1,12,2,UK,11,0.5520743743033365,-1.813999036030617,2,0,3
4,8,7,0,1,0.0,0,0,12,7,UK,442,0.5861579829519226,-0.8834366438501334,2,0,2
5,7,4,7,7,100.0,2,1,12,6,France,50,-0.6619208413875668,0.03938346978348012,1,0,2
7,8,1,7,7,71.0,0,0,15,1,France,20,-0.3352934160859125,0.8011847549738262,0,0,1
8,8,6,0,1,0.0,4,2,16,10,Australia,68,-0.32592868233536737,-1.5992276129457568,2,0,2
130,12,1,47,123,91.0,0,0,142,1,Germany,11,-1.3778143092097448,1.5562157964561663,1,0,1
3,2,32,0,1,0.0,11,0,5,43,France,25,1.216927249093325,-2.090895032014125,2,0,3
8,8,36,3,2,0.0,0,0,16,36,France,475,-0.3041974811322358,0.16640709057448078,0,0,1
5,8,0,0,1,0.0,0,0,13,0,UK,418,1.2296015562652718,0.13122512192593447,3,3,0
8,8,0,0,1,0.0,0,0,16,0,Belgium,441,1.0497295573481782,0.3009051053742669,3,3,0
10,8,0,11,9,88.0,0,0,18,0,Bulgaria,35,0.20545818492870835,1.7639432578951861,0,3,0
3,8,0,1,2,0.0,12,0,11,12,Hong Kong,11,0.5687365297607132,-0.6661898381152678,2,0,3
12,8,1,8,10,90.0,3,0,20,4,Chypre,12,-0.8784691234876544,0.49224347653329,1,0,1
4,8,58,2,1,0.0,11,9,12,69,Italy,11,-0.41849745031535196,-1.7494519165359732,2,0,2
4,9,0,0,1,0.0,0,0,13,0,France,331,1.0968776389053823,0.012231054092929315,3,3,0
4,8,0,0,1,0.0,0,0,12,0,France,407,1.3419139293825872,0.025257607180264305,3,3,0
3,8,0,0,1,0.0,0,0,11,0,France,621,1.8211872325051166,-0.5087243978983329,3,3,3
18,10,75,9,7,100.0,49,3,28,124,Italy,11,-1.8398086394177307,-0.019493983214208043,1,0,1
6,8,1,2,3,100.0,3,0,14,4,Germany,22,-0.7282278166203318,0.4812202193981342,0,0,1
6,8,1,5,4,100.0,0,0,14,1,Italy,16,-0.3988638702880303,1.034236252353509,0,0,1
5,8,0,0,1,0.0,0,0,13,0,Spain,531,1.2296015562652718,0.13122512192593447,3,3,0
6,8,2,3,2,100.0,0,0,14,2,France,322,-0.38960715502947313,0.9333504547225943,0,0,1
5,8,43,4,2,100.0,0,1,13,43,Germany,14,-0.7269079640797552,0.2208881169329828,0,0,1
8,8,11,2,7,100.0,0,0,16,11,Italy,15,-0.5977451980020394,1.0220330051562658,0,0,1
24,17,111,4,12,90.9,27,0,41,138,Italy,12,-1.6117948767428452,0.250716450565524,1,0,1
21,9,7,0,5,80.0,12,4,30,19,Swiss,12,-1.2608020287377573,-0.5365404876650393,1,0,1
7,8,1,0,3,0.0,0,0,15,1,Spain,88,0.131211235003467,0.010833011057176272,2,0,2
5,8,0,0,1,0.0,0,0,13,0,Denmark,284,1.2296015562652718,0.13122512192593447,3,3,0
3,8,5,0,1,0.0,2,0,11,7,Spain,359,0.7457104678008646,-1.8726502427141254,2,0,3
11,8,1,10,9,100.0,0,0,19,1,France,15,-0.6353736694512125,1.2882085408370174,0,0,1
9,8,0,0,1,0.0,0,0,17,0,Spain,699,1.015136275760136,0.33363313402552847,3,3,0
8,8,1,12,3,100.0,0,0,16,1,Italy,11,-0.5156714132405606,1.1421227252326118,0,0,1
11,8,0,0,1,0.0,0,0,19,0,France,670,0.9598311910461207,0.38545158176405614,3,3,0
11,11,110,3,2,50.0,5,0,22,115,UK,139,-1.2407174813772766,-0.014008213721848357,1,0,1
3,9,0,1,1,0.0,0,0,12,0,France,241,1.296514991719301,-0.17807809293114837,3,3,3
7,8,0,1,1,0.0,0,0,15,0,Italy,56,0.8676255048808439,0.5586329744394559,3,3,0
12,8,1,2,3,66.0,0,0,20,1,Italy,15,-0.4370600647881134,0.856399820366607,0,0,1
4,8,118,11,2,100.0,0,0,12,118,Spain,13,-0.4228465593920365,0.5720318066613895,0,0,1
36,12,35,60,62,87.0,2,2,48,37,France,12,-1.8994752182451706,0.12884048861298134,1,0,1
15,16,253,1,5,80.0,432,6,31,685,Sweden,15,-1.8706126374264187,-0.6510583018417516,1,0,1
20,8,0,0,1,0.0,0,0,28,0,Swiss,652,0.8261692431966411,0.5112159095950009,3,3,0
7,10,1,11,4,75.0,7,0,17,8,Spain,12,-0.9894182755745671,0.18826071606306444,1,0,1
5,8,0,0,1,0.0,0,0,13,0,Germany,206,1.2296015562652718,0.13122512192593447,3,3,0
4,8,0,0,1,0.0,0,0,12,0,Netherlands,660,1.3419139293825872,0.025257607180264305,3,3,0
5,9,7,0,2,100.0,2,3,14,9,France,70,-0.9520283176093846,-0.5542374111208878,1,0,1
11,8,0,3,5,83.0,0,0,19,0,France,37,0.2302748435600921,1.7067956519119154,0,3,0
4,8,3,5,2,0.0,0,0,12,3,US,14,0.08620937511829162,0.040055591202306264,2,0,1
5,8,0,0,1,0.0,0,0,13,0,France,698,1.2296015562652718,0.13122512192593447,3,3,0
7,8,2,4,5,0.0,0,0,15,2,France,48,-0.17185421715070057,0.3498281060760288,0,0,1
147,10,77,26,174,74.0,104,1,157,181,UK,11,-2.3304614379087116,0.496703319516024,1,0,1
5,8,0,0,1,0.0,0,0,13,0,France,423,1.2296015562652718,0.13122512192593447,3,3,0
6,8,2,2,5,40.0,170,4,14,172,UK,12,-1.0575153321473352,-0.5921948690884382,1,0,1
10,8,14,1,7,85.0,6,0,18,20,France,118,-0.8687416390047242,0.2333767936155435,1,0,1
4,8,1,1,2,0.0,0,0,12,1,France,73,0.16529473978519532,0.048577295124595736,2,0,1
9,8,0,0,6,100.0,0,0,17,0,Italy,97,0.3870786815688112,1.6571283783557371,0,3,0
4,8,0,0,1,0.0,0,3,12,0,France,493,1.0558711913549614,-0.49587826865102247,3,3,0
13,12,7,10,16,87.0,0,0,25,7,Italy,11,-0.9377697391065448,0.8683243950589429,1,0,1
4,8,5,0,1,0.0,13,1,12,18,France,80,-0.05339630603874017,-1.8964972806072873,2,0,2
4,8,0,1,2,0.0,0,0,12,0,Italy,599,0.8413762523236226,0.861568458025467,3,3,0
28,9,11,7,13,84.0,1,0,37,12,France,13,-1.3001745767627908,0.5429826633543997,1,0,1
9,8,1,0,2,100.0,0,1,17,1,Italy,17,-0.5189033871086594,0.28242390122360456,0,0,1
10,10,29,0,3,100.0,9,4,20,38,Spain,11,-1.3380721795710753,-0.4535110692866451,1,0,1
9,8,0,0,1,0.0,0,0,17,0,UK,644,1.015136275760136,0.33363313402552847,3,3,0
4,8,1,1,2,100.0,0,3,12,1,Germany,16,-0.4384547868014102,0.2414339553856404,0,0,1
7,8,0,0,1,0.0,0,0,15,0,Italy,659,1.0955486418094451,0.2577140011050194,3,3,0
6,8,0,0,2,100.0,4,1,14,4,UK,104,-0.41276119894964886,0.02465482503705707,1,0,1
16,17,14,24,33,87.0,0,0,33,14,Italy,13,-1.1272167970234819,0.953857205756944,1,0,1
6,8,0,0,1,0.0,29,3,14,29,France,574,0.08046633206628548,-1.3617544702347555,2,0,2
3,8,72,0,1,0.0,0,0,11,72,UK,94,0.9541263986095365,-1.5512314771427411,2,0,3
3,8,2,2,2,0.0,0,0,11,2,Portugal,13,0.602604603220643,-0.5022297163440715,2,0,3
5,8,0,0,4,100.0,0,0,13,0,Germany,621,0.613743676728953,1.4307611594907377,0,3,0
18,8,1,4,3,100.0,0,0,26,1,US,201,-0.6925396126982949,1.2989012910897744,0,0,1
18,9,4,7,33,93.0,2,0,27,6,France,16,-1.2118212565987565,0.5472356204350185,1,0,1
8,8,2,0,8,100.0,2,0,16,4,France,37,-0.6315762014181522,0.31315473110423614,0,0,1
12,9,11,2,12,58.0,0,0,21,11,Spain,93,-0.757603988857499,0.756446254943687,0,0,1
8,8,0,1,1,0.0,4,0,16,4,US,542,0.11171112066165478,-0.33679879594873685,2,0,1
21,8,12,7,44,93.0,9,3,29,21,Italy,11,-1.435669287613868,0.04628289050086203,1,0,1
7,8,0,0,2,100.0,0,0,15,0,Spain,488,0.5052273131201019,1.5070984147081161,0,3,0
12,8,0,0,1,0.0,0,0,20,0,Spain,670,0.9363231343322689,0.40766584312921067,3,3,0
5,8,15,0,1,0.0,18,1,13,33,Netherlands,606,-0.21080446693739358,-1.8459613000814759,2,0,2
12,9,19,0,7,100.0,2,16,21,21,Belgium,13,-1.3220012705868305,-0.33187738125899374,1,0,1
4,8,0,0,2,100.0,0,0,12,0,France,383,0.7515926006932439,1.2746420207833618,0,3,0
6,8,40,1,4,75.0,52,1,14,92,France,59,-1.0470481240109284,-0.5869045463194176,1,0,1
28,52,35,21,10,90.0,1,0,80,36,Italy,11,-1.7033081416224476,0.49433201779722236,1,0,1
4,10,11,0,1,0.0,0,0,14,11,France,13,0.22318326609124287,-0.8976601361712346,2,0,2
14,8,7,5,14,100.0,0,5,22,7,UK,79,-1.0709419492739158,0.7203162184199837,1,0,1
3,8,0,0,1,0.0,0,0,11,0,Belgium,19,1.8211872325051166,-0.5087243978983329,3,3,3
3,8,10,1,1,0.0,0,1,11,10,Belgium,120,0.5564193887510589,-1.6202596877682052,2,0,3
12,8,0,8,16,87.0,0,0,20,0,Spain,22,0.14318113520560985,1.83942715583158,0,3,0
14,9,5,2,7,85.0,0,0,23,5,Italy,13,-0.7507681709125191,0.8126515993241762,0,0,1
7,8,0,0,1,0.0,1,0,15,1,US,359,0.43416101709894517,-0.6169139311298638,2,0,1
8,10,0,0,1,0.0,349,1,18,349,Germany,11,-0.38053724123459215,-1.4439027974512146,2,0,2
15,8,0,2,6,50.0,0,0,23,0,Belgium,312,0.16890119155026007,1.7534268364611423,0,3,0
3,9,3,0,1,0.0,0,0,12,3,France,293,0.8035648438658951,-1.3457865678483347,2,0,3
4,8,32,0,1,0.0,0,1,12,32,Denmark,18,0.24977619604188414,-1.4537314317868701,2,0,2
4,8,4,0,1,0.0,9,3,12,13,Italy,18,-0.05166726962882901,-1.90400633537382,2,0,2
9,9,0,0,1,0.0,2,2,18,2,Belgium,32,-0.13570918367643767,-1.1428062578471574,2,0,2
35,89,35,2,15,60.0,2,0,124,37,France,385,-1.748705251005095,0.4482919227975403,1,0,1
15,10,10,49,13,92.0,0,0,25,10,Italy,11,-0.9496953259756302,0.9284440122036189,0,0,1
5,8,34,0,2,0.0,0,0,13,34,France,348,0.1287914690555273,-0.32922221331453977,2,0,2
7,11,59,1,2,100.0,10,4,18,69,Netherlands,13,-1.5428640960467763,-0.3054405274006873,1,0,1
5,8,3,0,1,0.0,3,0,13,6,UK,346,0.16230500543534637,-1.2244060964339636,2,0,2
7,8,2,3,4,100.0,4,0,15,6,UK,13,-0.834011805318074,0.534305716107954,1,0,1
6,8,1,0,1,0.0,0,0,14,1,Spain,353,0.4792107386002136,-0.6114953933053205,2,0,2
4,8,0,2,2,0.0,0,0,12,0,Italy,14,0.828058232801654,0.8791517749954076,3,3,0
10,8,0,9,12,100.0,0,0,18,0,UK,12,0.05913755897787735,2.0942295369814365,0,3,0
3,8,0,0,1,0.0,0,1,11,0,UK,87,1.5535504108640932,-0.9963268814024834,3,3,3
3,8,0,0,1,0.0,0,0,11,0,France,612,1.8211872325051166,-0.5087243978983329,3,3,3
23,12,79,1,23,95.0,12,0,35,91,Italy,13,-1.4869914018520218,0.28533759256298735,1,0,1
4,8,0,0,2,100.0,0,0,12,0,UK,275,0.7515926006932439,1.2746420207833618,0,3,0
7,9,18,0,1,0.0,0,0,16,18,US,419,0.10135237706242815,-0.7509694477324673,2,0,2
3,8,0,0,1,0.0,0,0,11,0,France,675,1.8211872325051166,-0.5087243978983329,3,3,3
4,12,81,0,3,66.0,11,4,16,92,Italy,97,-1.1012414620166546,-1.071203013137073,1,0,1
10,11,21,3,2,0.0,2,0,21,23,US,103,-0.9599292411289876,-0.2796743436126033,1,0,2
3,8,0,0,3,100.0,0,0,11,0,France,503,1.2152245496785863,0.7713783110470267,3,3,3
18,11,41,7,11,100.0,2,2,29,43,Germany,11,-1.7798130996721873,0.13423299380476703,1,0,1
5,8,0,0,1,0.0,0,0,13,0,US,616,1.2296015562652718,0.13122512192593447,3,3,0
17,12,65,0,2,100.0,7,7,29,72,UK,67,-1.5329995175281277,-0.44606915395591645,1,0,1
9,8,13,0,1,0.0,1,0,17,14,Germany,642,-0.08379374455723758,-1.0561128714062984,2,0,2
7,8,2,0,1,0.0,0,0,15,2,US,28,0.39082170910590414,-0.5896854851558625,2,0,2
4,8,6,2,4,50.0,0,0,12,6,UK,16,-0.110914450504844,0.39710791706635323,0,0,1
127,40,863,40,87,89.0,68,0,167,931,Italy,11,-2.2125490544482305,0.519023339629476,1,0,1
8,8,1,0,4,50.0,0,0,16,1,US,151,-0.08860022444426033,0.4422382339780139,0,0,1
6,8,20,0,1,0.0,17,2,14,37,Italy,371,-0.30537458204159124,-1.8067881684436191,2,0,2
13,13,4,0,2,0.0,0,0,26,4,France,675,-0.4119098067283788,-0.007475055390661401,2,0,1
8,8,5,0,2,0.0,3,0,16,8,France,622,-0.30748870869477396,-0.5399923398668859,2,0,2
4,8,2,0,1,0.0,0,0,12,2,UK,567,0.6371869966790462,-0.8221418790806176,2,0,2
21,8,1,19,11,63.0,0,0,29,1,Italy,30,-0.6494983511624873,1.1169429720827428,0,0,1
4,8,0,0,1,0.0,0,0,12,0,Italy,38,1.3419139293825872,0.025257607180264305,3,3,0
3,10,79,0,1,0.0,1,0,13,80,France,51,0.2085242506921189,-1.9338115732696501,2,0,3
6,8,2,1,2,50.0,0,0,14,2,France,170,-0.21406953690053665,0.5591879242120175,0,0,1
4,8,20,1,2,50.0,1,0,12,21,Ireland,14,-0.4419172565152967,-0.18378524142221492,2,0,1
4,8,0,1,2,100.0,0,0,12,0,Italy,13,0.5236694637646426,1.5755609941177986,0,3,0
5,9,1,0,2,0.0,0,0,14,1,Italy,410,0.06305198085212499,-0.1818742360152959,2,0,2
4,8,1,1,5,100.0,0,0,12,1,France,11,-0.185292914726615,0.8271450682833267,0,0,1
4,8,1,1,1,0.0,9,0,12,10,US,420,0.04211039434880871,-1.0398474359625955,2,0,2
14,8,3,2,6,50.0,2,0,22,5,Netherlands,22,-0.8735449868786764,0.39631005394764246,1,0,1
5,11,0,0,2,0.0,13,1,16,13,France,135,-0.43353078187460964,-0.8279643041615636,1,0,2
10,10,339,0,9,88.0,31,14,20,370,Australia,40,-1.4082970406829718,-0.9319944138261858,1,0,1
5,8,0,0,1,0.0,0,0,13,0,Netherlands,699,1.2296015562652718,0.13122512192593447,3,3,0
3,8,0,0,1,0.0,0,0,11,0,France,610,1.8211872325051166,-0.5087243978983329,3,3,3
25,10,0,1,26,100.0,0,0,35,0,Italy,40,-0.35493898558869125,2.184815062464346,0,3,0
3,8,0,1,1,0.0,0,1,11,0,UK,58,1.3256272739354915,-0.6954079080680463,3,3,3
7,10,118,0,1,0.0,7,0,17,125,Austria,14,-0.4169406709290629,-1.3646987973652562,2,0,2
46,19,1308,63,87,92.0,564,36,65,1872,Spain,11,-2.4233778598276805,-0.30525695778111867,1,0,1
6,8,14,0,2,100.0,1,3,14,15,France,11,-0.823729329166364,-0.46447995595665337,1,0,1
3,8,0,4,2,0.0,0,0,11,0,France,12,1.2913921722013428,0.3662139562671586,3,3,3
10,8,4,0,10,70.0,0,0,18,4,France,180,-0.24227805789339155,0.5006755280856999,0,0,1
4,8,0,0,4,75.0,0,0,12,0,Italy,105,0.8729465669029078,0.9946819298620407,3,3,0
4,8,0,0,1,0.0,0,0,12,0,France,645,1.3419139293825872,0.025257607180264305,3,3,0
13,8,0,1,8,87.0,0,0,21,0,UK,29,0.19233656335690288,1.7512608192320762,0,3,0
7,8,3,0,1,0.0,0,0,15,3,Netherlands,60,0.37467535702743776,-0.6090755004777307,2,0,2
41,85,69,12,17,58.0,0,0,126,69,Italy,14,-1.5079022669194935,0.9500370152188007,1,0,1
4,8,0,2,3,100.0,0,0,12,0,UK,390,0.4947100901054868,1.6238626064300015,0,3,0
51,9,66,13,65,90.0,1,0,60,67,Spain,11,-1.5814362774451565,0.6854517923587752,1,0,1
6,8,0,2,4,50.0,0,0,14,0,France,18,0.45180282543405986,1.4743223514045454,0,3,0
6,8,0,2,4,50.0,0,0,14,0,Belgium,57,0.45180282543405986,1.4743223514045454,0,3,0
8,8,0,4,7,85.0,0,0,16,0,France,88,0.3018193608263874,1.6540018978484015,0,3,0
205,2013,35,3,1,0.0,4,0,2218,39,France,45,-1.8281577877368487,-0.154414151849582,1,0,1
8,8,0,0,1,0.0,0,0,16,0,France,686,1.0497295573481782,0.3009051053742669,3,3,0
9,8,0,0,1,0.0,0,0,17,0,France,693,1.015136275760136,0.33363313402552847,3,3,0
27,17,699,8,14,64.0,2,28,44,701,Netherlands,11,-2.026532731064243,-0.3883804279404603,1,0,1
4,8,1,0,3,66.0,0,0,12,1,France,254,0.20977188671277444,0.15548929411328308,0,0,1
11,13,3,1,2,0.0,0,0,24,3,Italy,37,-0.5975978248071927,0.2780819975910979,1,0,1
21,9,12,7,10,80.0,0,0,30,12,Italy,15,-0.9035659191088414,0.8992323662476602,0,0,1
7,8,0,6,2,0.0,0,1,15,0,Lituanie,221,0.2891198246381389,0.656928211754131,0,3,0
8,8,0,3,1,0.0,0,0,16,0,France,11,0.7998784125729486,0.6307748631590951,3,3,0
18,15,10,0,1,0.0,66,0,33,76,Italy,139,-0.6947974560827814,-1.1312204889709232,2,0,2
16,15,1,4,18,44.0,3,0,31,4,Italy,30,-1.2725681860633031,0.4453296469769702,1,0,1
4,8,0,0,1,0.0,0,0,12,0,Spain,386,1.3419139293825872,0.025257607180264305,3,3,0
8,0,1,1,2,100.0,0,0,8,1,France,17,0.8334427501500065,0.9265200616553994,0,1,2
6,9,2,1,1,0.0,2,1,15,4,France,357,-0.5936065674945906,-1.356036717245976,2,0,2
4,8,0,0,2,100.0,0,0,12,0,France,597,0.7515926006932439,1.2746420207833618,0,3,0
5,8,0,0,2,0.0,0,0,13,0,Spain,581,0.9569870161349087,0.6666169994366998,3,3,0
4,8,0,0,1,0.0,0,0,12,0,US,507,1.3419139293825872,0.025257607180264305,3,3,0
5,8,0,2,2,0.0,0,0,13,0,Italy,366,0.7157458596843389,0.9851192897410775,3,3,0
4,8,0,0,2,100.0,0,0,12,0,Italy,231,0.7515926006932439,1.2746420207833618,0,3,0
28,9,11,17,26,82.6,0,0,37,11,Italy,11,-1.019945428942795,1.056713829703935,0,0,1
10,8,0,3,15,93.0,0,1,18,0,Sweden,11,-0.05317911358520771,1.2798897128091342,0,3,0
56,8,727,4,66,83.0,16,0,64,743,France,11,-1.5873197392668463,0.4999237409135944,1,0,1
4,8,2,0,1,0.0,1,0,12,3,Italy,11,0.3129587317185129,-1.2806092005130094,2,0,2
45,8,0,17,84,98.7,0,0,53,0,Italy,11,-0.22719754735992154,2.257592211386359,0,3,0
5,9,63,0,1,0.0,1,0,14,64,France,188,-0.16389487337179734,-1.38620815911672,2,0,2
29,8,0,3,3,0.0,0,0,37,0,France,658,0.1986507815672068,1.491251370551032,0,3,0
3,8,0,0,1,0.0,0,0,11,0,Finland,19,1.8211872325051166,-0.5087243978983329,3,3,3
3,8,4,0,1,0.0,0,0,11,4,France,138,1.0880433111556689,-1.3902393007833025,2,0,3
4,5,82,0,2,0.0,0,8,9,82,France,573,0.5038836053661602,-1.188299732514998,2,0,2
42,9,0,0,3,0.0,0,0,51,0,US,690,0.20220661951460808,1.1595411919174994,0,3,0
23,8,10,6,16,100.0,1,0,31,11,France,12,-1.2199418500820827,0.9029589636261498,1,0,1
3,8,1,1,1,0.0,0,0,11,1,Belgium,596,0.9171825830380885,-1.020796587464767,2,0,3
4,9,2,0,2,66.0,0,0,13,2,France,320,-0.04826846979235646,0.07733612232367498,0,0,1
6,8,11,1,8,87.0,0,2,14,11,UK,11,-0.6205756053314813,0.08712043358525322,1,0,1
5,8,0,1,2,100.0,0,0,13,0,Netherlands,84,0.4113570906473278,1.6815285088634686,0,3,0
18,8,16,4,28,100.0,0,0,26,16,Italy,11,-0.8797776269849632,1.3016649326724088,0,0,1
8,8,0,0,1,0.0,0,0,16,0,Romania,599,1.0497295573481782,0.3009051053742669,3,3,0
6,8,0,5,17,94.0,0,0,14,0,Italy,72,0.3672057178973523,1.6318900012363518,0,3,0
6,8,0,1,3,0.0,0,0,14,0,France,524,0.6391132199424889,1.0685249157830154,3,3,0
58,8,2,62,50,100.0,0,0,66,2,Italy,11,-1.1343708874543053,1.7713676143292088,0,0,1
6,8,0,0,2,0.0,0,0,14,0,France,43,0.8826777110082775,0.736887647106316,3,3,0
8,8,0,0,1,0.0,0,0,16,0,UK,551,1.0497295573481782,0.3009051053742669,3,3,0
4,8,17,2,1,0.0,3,0,12,20,UK,11,-0.029956289605314806,-1.0876721586497222,2,0,2
47,8,13,25,43,93.0,19,0,55,32,Italy,11,-1.3917465773175712,0.7453342569861477,1,0,1
5,8,12,0,1,0.0,18,1,13,30,UK,265,-0.2032668499374216,-1.8369843216459272,2,0,2
5,10,61,0,3,66.0,13,0,15,74,France,14,-0.7560416420136379,-0.49440787293637445,1,0,1
5,8,5,1,3,66.0,0,0,13,5,Netherlands,225,-0.19634769691071294,0.4832473037535273,0,0,1
8,8,46,1,5,100.0,15,4,16,61,Denmark,11,-1.3054305651727494,-0.1515251720338222,1,0,1
6,8,68,3,3,66.0,10,0,14,78,Grèce,11,-0.7701409495602324,-0.06791603873552336,1,0,1
4,9,118,2,1,0.0,4,3,13,122,US,14,-0.6622349118581635,-1.744396663119399,2,0,2
6,14,0,0,1,0.0,0,0,20,0,Belgium,426,0.7197626227547778,0.19746885037348438,3,3,0
4,8,0,1,1,0.0,0,0,12,0,Italy,364,1.1139907924539865,0.32617658051470094,3,3,0
4,9,2,1,1,0.0,5,0,13,7,Spain,48,-0.2015063858641491,-1.0484320881048586,2,0,2
5,8,0,0,1,0.0,0,0,13,0,France,468,1.2296015562652718,0.13122512192593447,3,3,0
5,8,0,1,1,0.0,0,0,13,0,France,647,1.0016784193366708,0.4321440952603711,3,3,0
4,8,13,0,3,66.0,5,2,12,18,France,11,-0.5226876523248206,-0.9718466081157906,2,0,1
40,174,13,0,5,100.0,1900,41,214,1913,Bulgaria,112,-2.3423910366034613,-0.547712042965213,1,0,1
7,8,52,2,2,50.0,61,0,15,113,Italy,15,-0.8331456728783315,-0.10665132819898275,1,0,1
18,14,83,3,14,100.0,16,0,32,99,Croatie,11,-1.6276220100323855,0.5358430723791271,1,0,1
23,8,0,0,13,100.0,0,0,31,0,US,161,0.14070378024630067,1.9157934197906308,0,3,0
4,9,5,0,1,0.0,0,1,13,5,UK,11,0.08727523114835965,-1.3674910707519543,2,0,2
3,9,6,0,3,100.0,1,0,12,7,Netherlands,20,-0.15055132973320148,-0.5527336163374982,2,0,3
13,8,1,1,9,100.0,0,0,21,1,France,116,-0.628758859713899,1.2630022970923427,0,0,1
25,12,58,4,9,80.0,11,0,37,69,Portugal,11,-1.4769694600632133,0.2875134888970325,1,0,1
3,8,0,0,1,0.0,0,0,11,0,UK,330,1.8211872325051166,-0.5087243978983329,3,3,3
6,8,0,3,1,0.0,0,0,14,0,France,36,0.9054411063634108,0.531365527380379,3,3,0
4,9,2,0,1,0.0,0,0,13,2,Australia,86,0.39215070620184167,-0.8351684321679522,2,0,2
4,8,0,0,1,0.0,0,0,12,0,US,608,1.3419139293825872,0.025257607180264305,3,3,0
3,8,0,0,1,0.0,0,0,11,0,France,692,1.8211872325051166,-0.5087243978983329,3,3,3
5,8,0,0,1,0.0,0,0,13,0,Italy,18,1.2296015562652718,0.13122512192593447,3,3,0
6,8,0,0,2,0.0,0,0,14,0,US,385,0.8826777110082775,0.736887647106316,3,3,0
23,8,0,0,2,0.0,0,0,31,0,US,642,0.5223353024076254,1.0762581187145657,3,3,0
4,8,1,0,1,0.0,0,0,12,1,US,572,0.6658324168441598,-0.7877335557206069,2,0,2
3,8,16,0,1,0.0,2,0,11,18,US,232,0.700671077798584,-1.926662391119556,2,0,3
3,9,1,4,3,100.0,1,1,12,2,Spain,15,-0.6128469390001589,-0.6260557531590989,1,0,3
3,8,0,0,1,0.0,0,0,11,0,France,483,1.8211872325051166,-0.5087243978983329,3,3,3
3,8,14,4,1,0.0,4,2,11,18,Italy,11,0.1568892084356008,-2.107015362734713,2,0,3
4,8,0,0,2,0.0,0,0,12,0,Italy,131,1.0692993892522238,0.5606494846910302,3,3,0
10,8,2,2,13,92.3,0,0,18,2,Italy,12,-0.4763360165056102,0.8981583387977917,0,0,1
14,9,0,1,7,100.0,0,0,23,0,UK,100,-0.1374824533396377,2.0063042783665157,0,3,0
11,8,1,3,2,0.0,0,0,19,1,US,467,-0.2387160063979,0.437722054158779,0,0,1
11,10,79,0,2,100.0,70,12,21,149,US,75,-1.460535066434765,-0.6241024607715302,1,0,1
8,15,52,1,1,0.0,7,0,23,59,Denmark,22,-0.7796578062536041,-0.9530356788102184,2,0,2
6,10,10,4,3,0.0,0,0,16,10,France,14,-0.448339474878532,0.1429295060419141,0,0,1
16,8,2,1,4,100.0,0,0,24,2,France,381,-0.678589936049423,1.223438037592759,0,0,1
5,8,2,5,4,100.0,1,0,13,3,France,11,-0.6774282502870461,0.47108995989149033,0,0,1
3,8,0,1,1,0.0,0,0,11,0,Italy,618,1.5932640955765163,-0.20780542456389617,3,3,3
37,8,3,0,20,90.0,0,0,45,3,Italy,407,-0.5663077033800157,0.867491749266585,0,0,1
35,9,2,185,87,94.0,2,0,44,4,Italy,11,-1.4532564314311966,0.8889049590328859,1,0,1
7,8,0,0,1,0.0,0,0,15,0,Italy,630,1.0955486418094451,0.2577140011050194,3,3,0
13,14,12,5,12,58.0,3,1,27,15,UK,11,-1.5655703389094275,-0.1856108704129143,1,0,1
3,8,1,0,4,75.0,0,0,11,1,France,634,0.6761383574870106,-0.3522912381174279,2,0,3
11,8,2,0,2,100.0,0,0,19,2,Italy,30,-0.33521707034676373,0.7874365091062718,0,0,1
3,8,14,0,1,0.0,9,1,11,23,Sweden,12,0.4060492764469015,-2.452127159508804,2,0,3
7,8,0,13,4,100.0,0,0,15,0,Italy,11,0.19470671040346596,1.9335045491198526,0,3,0
4,8,4,1,3,100.0,0,0,12,4,France,12,-0.22511581172199296,0.7247643865750909,0,0,1
7,8,0,1,2,100.0,0,0,15,0,Italy,12,0.27730417619150066,1.8080173880425527,0,3,0
14,22,46,8,8,62.0,139,3,36,185,France,107,-1.8561126062944615,-0.40489257195319633,1,0,1
5,8,1,7,9,66.0,3,0,13,4,Spain,11,-0.5674077269408971,0.17995342863865033,1,0,1
4,8,0,0,1,0.0,0,0,12,0,France,616,1.3419139293825872,0.025257607180264305,3,3,0
5,8,15,6,3,66.0,0,1,13,15,Germany,14,-0.548036820420452,-0.008910947624300615,1,0,1
10,8,65,4,8,37.0,12,2,18,77,Belgium,11,-1.25290824390345,-0.3636113482383021,1,0,1
3,8,0,1,1,0.0,0,0,11,0,France,338,1.5932640955765163,-0.20780542456389617,3,3,3
3,8,0,0,1,0.0,0,0,11,0,UK,671,1.8211872325051166,-0.5087243978983329,3,3,3
8,8,0,0,1,0.0,0,0,16,0,France,329,1.0497295573481782,0.3009051053742669,3,3,0
7,8,55,0,2,0.0,1,1,15,56,UK,11,-0.6139878182201401,-1.1688318447965034,2,0,1
5,8,24,0,1,0.0,0,0,13,24,Netherlands,341,0.41907861852867234,-0.8433620679895923,2,0,2
14,10,241,1,1,0.0,23,0,24,264,Italy,98,-0.8707443787293617,-0.9917389497173632,2,0,2
4,8,1,3,2,0.0,0,0,12,1,Italy,157,0.14336673193856667,0.07752807957498714,2,0,1
8,8,1,0,1,0.0,0,0,16,1,France,493,0.3736480448097511,-0.5120860575266041,2,0,2
4,8,0,0,1,0.0,0,0,12,0,Swiss,652,1.3419139293825872,0.025257607180264305,3,3,0
3,8,3,0,2,0.0,2,2,11,5,France,21,0.21183415547823428,-1.8243813911661897,2,0,3
4,8,0,1,1,0.0,0,0,12,0,UK,116,1.1139907924539865,0.32617658051470094,3,3,0
6,8,0,6,6,100.0,0,0,14,0,Italy,11,0.26105720154739803,1.8764158305682554,0,3,0
6,9,2,0,1,0.0,0,1,15,2,UK,64,-0.02544402875524633,-1.1768447451341884,2,0,2
11,8,1,1,2,100.0,6,1,19,7,Italy,137,-1.1845058394365886,0.09995930239529771,1,0,1
3,8,1,3,1,0.0,0,0,11,1,Italy,84,0.8952545751914599,-0.9918458030143759,2,0,3
13,22,16,0,1,0.0,0,0,35,16,Italy,216,-0.3120130487900034,-0.5826343458271247,2,0,2
14,8,88,0,5,100.0,7,14,22,95,US,154,-1.264271117879869,-0.3659653406937836,1,0,1
6,9,1,0,1,0.0,1,2,15,2,France,25,-0.33859951289832996,-1.6292788709297257,2,0,2
4,8,1,0,1,0.0,0,0,12,1,France,404,0.6658324168441598,-0.7877335557206069,2,0,2
9,8,3,5,41,78.0,1,1,17,4,UK,11,-1.1006720809329036,-0.015497176159152842,1,0,1
4,8,0,0,4,100.0,0,0,12,0,France,60,0.7260560498462683,1.3247936447450679,0,3,0
3,8,0,0,1,0.0,0,0,11,0,France,487,1.8211872325051166,-0.5087243978983329,3,3,3
3,8,0,0,1,0.0,0,0,11,0,France,576,1.8211872325051166,-0.5087243978983329,3,3,3
3,8,0,1,1,0.0,0,0,11,0,France,17,1.5932640955765163,-0.20780542456389617,3,3,3
25,52,733,0,3,0.0,67,11,77,800,Italy,13,-1.7349399238411112,-1.258788739682187,1,0,1
7,8,1,1,2,0.0,0,0,15,1,Italy,13,-0.08107054778794676,0.2810336890493507,0,0,1
6,8,0,0,1,0.0,0,0,14,0,UK,399,1.155292251138641,0.2014957695955506,3,3,0
35,10,9,7,22,88.8,7,4,45,16,Italy,11,-1.7433236343051621,0.02869542638500747,1,0,1
15,8,0,2,21,80.0,0,0,23,0,France,509,0.11979634361088767,1.8523643405803623,0,3,0
8,9,118,0,2,100.0,25,4,17,143,Italy,17,-1.2907647444841,-0.6445877215124769,1,0,1
5,8,0,0,1,0.0,0,0,13,0,UK,162,1.2296015562652718,0.13122512192593447,3,3,0
6,8,12,7,2,100.0,0,0,14,12,Portugal,11,-0.4828733230877276,0.8724878498068726,0,0,1
4,8,5,1,1,0.0,0,0,12,5,France,220,0.3720252063379877,-0.5659430608260326,2,0,2
9,8,0,10,10,100.0,0,0,17,0,US,36,0.09227619934186163,2.0567198743454416,0,3,0
5,9,1,0,1,0.0,0,0,14,1,Kazakhstan,11,0.3356665209824884,-0.7172661135260615,2,0,2
62,16,91,8,27,41.6,106,8,78,197,Sweden,11,-2.118381289410732,-0.14611714810363868,1,0,1
3,8,0,0,1,0.0,15,3,11,15,UK,62,0.7733396753832088,-2.0367387740793936,2,0,3
3,8,0,0,1,0.0,0,0,11,0,Austria,670,1.8211872325051166,-0.5087243978983329,3,3,3
5,8,5,1,1,0.0,0,0,13,5,Spain,439,0.25971283322067246,-0.45997554608036234,2,0,2
11,8,27,0,1,0.0,25,7,19,52,Germany,12,-0.5447070044731385,-1.6911658447734357,2,0,2
7,8,0,10,8,100.0,1,0,15,1,US,40,-0.4808633550048476,1.0907841492801884,0,0,1
4,8,0,0,1,0.0,0,2,12,0,France,675,1.062899733902033,-0.48307309939085447,3,3,0
3,8,0,0,1,0.0,0,0,11,0,UK,48,1.8211872325051166,-0.5087243978983329,3,3,3
6,8,135,8,2,0.0,20,1,14,155,Italy,15,-0.9303295387071115,-0.9982057707454021,1,0,1
10,8,8,6,3,66.0,8,4,18,16,France,11,-1.1514513018907047,-0.30382195598212103,1,0,1
3,8,0,0,1,0.0,3,19,11,3,France,22,0.799973960478882,-2.019535817363975,2,0,3
11,9,2,0,1,0.0,0,0,20,2,Italy,427,0.07273280536123046,-0.5267829952209117,2,0,2
7,8,0,7,6,100.0,0,0,15,0,Italy,14,0.19733424030583738,1.9378878617057116,0,3,0
4,8,0,0,1,0.0,0,1,12,0,France,14,1.0742771077415625,-0.4623448763238855,3,3,0
28,17,19,0,2,100.0,1,0,45,20,US,231,-1.3049918845115878,0.3191299828553848,1,0,1
11,11,2280,1,1,0.0,0,70,22,2280,France,11,-0.9865411840349584,-1.3362003774833764,1,0,2
4,8,0,3,1,0.0,0,0,12,0,France,32,1.0920627846073576,0.3551273649650925,3,3,0
43,12,204,40,34,96.2,1,0,55,205,Italy,12,-1.7245507397859292,0.5434709056749355,1,0,1
4,8,0,0,1,0.0,0,0,12,0,France,420,1.3419139293825872,0.025257607180264305,3,3,0
5,8,3,1,6,50.0,0,0,13,3,Italy,45,-0.19364284935435333,0.543638091947644,0,0,1
4,8,0,0,1,0.0,0,0,12,0,France,658,1.3419139293825872,0.025257607180264305,3,3,0
6,8,0,10,3,100.0,0,0,14,0,Italy,11,0.27064462046036375,1.8495365015138867,0,3,0
6,8,0,0,1,0.0,0,0,14,0,Swiss,255,1.155292251138641,0.2014957695955506,3,3,0
94,9,5,10,33,28.0,0,0,103,5,Italy,77,-1.191138844754838,1.2800588602720653,1,0,1
5,8,1,3,5,100.0,0,0,13,1,Grèce,79,-0.31953329569055877,0.9620633674793879,0,0,1
4,8,0,0,1,0.0,0,3,12,0,UK,11,1.0558711913549614,-0.49587826865102247,3,3,0
5,5,0,0,1,0.0,0,0,10,0,France,505,1.9039539098763856,-0.06344546008016476,3,3,2
3,10,0,1,1,0.0,3,1,13,3,France,97,0.2020729287471312,-1.5476252582294516,2,0,3
6,8,0,0,1,0.0,0,0,14,0,Italy,620,1.155292251138641,0.2014957695955506,3,3,0
3,8,0,0,2,0.0,0,0,11,0,France,466,1.548572692374754,0.026667479612432644,3,3,3
8,11,26,4,4,75.0,14,20,19,40,Italy,49,-1.4908863610141307,-0.5445074617650743,1,0,1
8,8,1,9,6,100.0,0,0,16,1,France,16,-0.5307485782704405,1.1762499747378379,0,0,1
15,8,0,23,17,88.0,0,0,23,0,Spain,13,0.06351703030586026,1.926748720695747,0,3,0
5,8,27,3,1,0.0,0,0,13,27,UK,185,0.16389760718012225,-0.5199082898870083,2,0,2
12,8,2,1,6,80.0,0,0,20,2,Italy,51,-0.4795949463191518,0.8592903549608505,0,0,1
21,9,97,3,13,84.0,10,16,30,107,UK,42,-1.6736809307911211,-0.3114733391876367,1,0,1
176,60,276,18,81,92.0,1,0,236,277,Spain,11,-2.1463253676856864,0.74508756102672,1,0,1
5,8,1,0,3,100.0,2,1,13,3,Italy,203,-0.6685541876365161,-0.3795417402944757,1,0,1
5,8,0,0,1,0.0,0,0,13,0,France,644,1.2296015562652718,0.13122512192593447,3,3,0
3,10,0,3,3,100.0,0,0,13,0,Italy,87,0.541253194985336,1.173598790677561,0,3,3
5,8,0,0,1,0.0,0,0,13,0,France,333,1.2296015562652718,0.13122512192593447,3,3,0
4,8,21,1,1,0.0,1,0,12,22,UK,11,-0.007500607510233976,-1.0907146713464067,2,0,2
8,8,1,0,1,0.0,0,0,16,1,US,638,0.3736480448097511,-0.5120860575266041,2,0,2
5,8,7,1,1,0.0,0,0,13,7,UK,18,0.24592247290600625,-0.4765501557700265,2,0,2
5,8,1,0,1,0.0,0,0,13,1,UK,169,0.5535200437268449,-0.6817660409749369,2,0,2
4,8,0,0,1,0.0,0,0,12,0,Italy,388,1.3419139293825872,0.025257607180264305,3,3,0
7,0,133,1,1,0.0,0,2,7,133,Germany,11,0.9466585695754802,-1.1293613731601349,2,1,2
3,8,26,0,1,0.0,0,0,11,26,Belgium,17,1.0072987875143136,-1.487368725097589,2,0,3
4,9,1,0,2,0.0,0,0,13,1,France,478,0.14818158623659194,-0.26536823129717624,2,0,2
20,8,7,10,13,61.0,2,5,28,9,France,11,-1.3387256385767095,-0.003941906801139525,1,0,1
4,8,4,0,2,0.0,2,0,12,6,France,13,0.0014921909024961863,-0.7940936731855539,2,0,2
7,9,0,0,2,0.0,0,0,16,0,France,471,0.6246540164202253,0.7414233469189679,3,3,0
17,8,0,0,12,83.0,0,1,25,0,Pologne,55,0.08311734092697756,1.0401005120194409,0,3,0
23,9,1,1,4,100.0,0,0,32,1,Spain,586,-0.8996091431958841,1.2571496483900209,0,0,1
5,8,4,3,1,0.0,0,0,13,4,UK,378,0.24660649014059396,-0.42042002317420735,2,0,2
5,10,91,0,1,0.0,5,5,15,96,UK,70,-0.5982391113961406,-1.975715702843132,2,0,2
5,8,0,0,2,0.0,0,0,13,0,UK,663,0.9569870161349087,0.6666169994366998,3,3,0
4,8,0,0,1,0.0,0,0,12,0,France,11,1.3419139293825872,0.025257607180264305,3,3,0
24,21,57,39,11,81.0,859,16,45,916,Italy,11,-2.1170505538405715,-0.42878612967011304,1,0,1
10,8,0,5,9,100.0,0,0,18,0,US,16,0.08409895138566827,2.0542972963708737,0,3,0
13,9,20,0,12,91.0,3,2,22,23,UK,84,-1.191131397100036,-0.5313415726432872,1,0,1
4,8,0,1,1,0.0,0,0,12,0,Croatie,96,1.1139907924539865,0.32617658051470094,3,3,0
4,8,5,0,1,0.0,0,0,12,5,France,302,0.5999483432665889,-0.8668620341604695,2,0,2
5,8,0,0,1,0.0,0,0,13,0,France,631,1.2296015562652718,0.13122512192593447,3,3,0
9,10,35,3,3,0.0,0,0,19,35,Croatie,11,-0.6067978459272662,0.1635350942965047,1,0,1
3,9,11,1,1,0.0,3,7,12,14,France,11,-0.11700888481974557,-2.136845424761482,2,0,3
4,8,4,0,1,0.0,7,3,12,11,UK,188,-0.04356594618868691,-1.8932059956165381,2,0,2
9,9,1,0,4,75.0,0,0,18,1,UK,219,-0.3161097765682175,0.428394144068106,0,0,1
3,8,2,0,1,0.0,2,0,11,4,France,360,0.7762208979908332,-1.8362348296054387,2,0,3
7,8,0,1,3,100.0,0,0,15,0,France,11,0.2616628220543133,1.8387356833848154,0,3,0
3,8,0,2,2,0.0,0,0,11,0,France,394,1.307331535924184,0.3451697699168102,3,3,3
3,8,5,1,1,0.0,0,1,11,5,France,15,0.5836616878194927,-1.5875275494087795,2,0,3
6,8,0,0,7,85.0,0,0,14,0,France,72,0.6645625747902612,1.2150460854149583,0,3,0
14,8,1,3,8,62.0,0,0,22,1,Italy,15,-0.5110689400108244,0.9587819337026646,0,0,1
4,8,0,0,4,0.0,0,0,12,0,UK,683,1.043762838405248,0.6108011086527365,3,3,0
6,8,36,3,1,0.0,2,1,14,38,Grèce,22,-0.5223955858503493,-1.4219118453619077,2,0,2
5,8,1,0,2,100.0,5,47,13,6,France,260,-0.7529969134881245,-0.5787558300935424,1,0,1
7,8,0,0,4,75.0,0,0,15,0,Austria,214,0.6265812793297659,1.2271383237867957,0,3,0
14,10,65,20,20,90.0,117,3,24,182,UK,11,-1.7269002343431814,-0.31451123566396505,1,0,1
5,8,0,0,5,100.0,0,0,13,0,Italy,204,0.6063993616230984,1.445184772595431,0,3,0
7,8,0,0,2,100.0,0,0,15,0,Germany,35,0.5052273131201019,1.5070984147081161,0,3,0
4,8,6,1,1,0.0,7,1,12,13,Islande,31,-0.26497100884679836,-1.5728985720039559,2,0,2
9,8,7,1,3,66.0,0,0,17,7,France,13,-0.4246033377305154,0.6690807061634574,0,0,1
5,22,29,20,2,100.0,0,0,27,29,France,11,-1.0747894543143228,0.8629124570078749,1,0,1
8,8,0,0,1,0.0,0,0,16,0,Estonie,652,1.0497295573481782,0.3009051053742669,3,3,0
15,8,2,3,7,71.0,1,0,23,3,UK,33,-0.8788197485741045,0.48042729847749055,1,0,1
4,8,0,1,1,0.0,0,0,12,0,Spain,378,1.1139907924539865,0.32617658051470094,3,3,0
3,8,21,0,4,75.0,0,2,11,21,Italy,27,0.26922812837600485,-1.0143424057680626,2,0,3
4,8,0,0,1,0.0,0,0,12,0,US,681,1.3419139293825872,0.025257607180264305,3,3,0
5,9,69,0,1,0.0,3,0,14,72,UK,14,-0.18633502217789089,-1.4167142031645963,2,0,2
5,8,3,0,2,0.0,0,0,13,3,France,376,0.2361137313529015,-0.2001725021460501,2,0,2
17,8,1,35,31,93.0,2,0,25,3,France,11,-1.019250788920229,0.7066042583526236,1,0,1
3,10,2,1,1,0.0,0,0,13,2,France,268,0.46441695295495455,-0.9828541889790716,2,0,3
31,8,6,1,24,76.0,0,0,39,6,Spain,13,-0.7878306191404213,1.0978306518338994,0,0,1
4,8,1,0,1,0.0,0,0,12,1,Italy,257,0.6658324168441598,-0.7877335557206069,2,0,2
42,79,1127,0,4,0.0,8,0,121,1135,Spain,62,-1.5266359359824566,-0.5875098824345398,1,0,2
4,9,0,0,1,0.0,0,0,13,0,France,650,1.0968776389053823,0.012231054092929315,3,3,0
48,8,9,0,30,93.0,1,0,56,10,France,131,-1.0028401845226127,0.4505322290901467,1,0,1
3,8,0,0,1,0.0,0,0,11,0,Italy,11,1.8211872325051166,-0.5087243978983329,3,3,3
4,8,0,0,1,0.0,0,0,12,0,France,314,1.3419139293825872,0.025257607180264305,3,3,0
3,9,1,0,1,0.0,0,0,12,1,France,618,0.848356616109475,-1.291988229166456,2,0,3
14,17,160,0,2,100.0,187,5,31,347,France,11,-1.7036262414147088,-0.628886443372607,1,0,1
7,8,0,0,2,100.0,0,0,15,0,France,561,0.5052273131201019,1.5070984147081161,0,3,0
3,8,0,0,1,0.0,0,0,11,0,UK,632,1.8211872325051166,-0.5087243978983329,3,3,3
7,9,22,0,1,0.0,11,0,16,33,US,41,-0.27367078315916626,-1.2787491792345076,2,0,2
3,8,1,0,2,0.0,0,0,11,1,France,61,0.8724911798363266,-0.7863236832884388,2,0,3
8,8,8,3,2,0.0,0,5,16,8,Sweden,11,-0.5303271927262884,-0.2888622033292828,1,0,1
5,7,3,2,1,0.0,11,0,12,14,France,13,0.22856154464161962,-0.897233067766133,2,0,2
6,9,169,0,2,100.0,103,3,15,272,Germany,52,-1.2497479383773313,-0.7854437411476854,1,0,1
4,8,0,0,1,0.0,0,0,12,0,France,167,1.3419139293825872,0.025257607180264305,3,3,0
3,8,50,0,1,0.0,8,0,11,58,UK,33,0.6223303911282707,-2.025547685810169,2,0,3
3,8,0,12,6,100.0,0,0,11,0,France,11,0.9097728630900112,1.1888769202457319,0,3,3
7,8,0,3,2,100.0,0,0,15,0,France,132,0.25537616834487203,1.8369681724929452,0,3,0
3,8,0,2,1,0.0,12,0,11,12,US,692,0.828033050369108,-1.1839983986560927,2,0,3
82,12,150,5,37,50.0,7,5,94,157,UK,106,-2.065496544303764,-0.022866434276279764,1,0,1
4,8,4,0,2,100.0,0,1,12,4,UK,150,-0.24918814229722897,-0.09447536560575823,0,0,1
6,8,0,3,1,0.0,0,0,14,0,France,184,0.9054411063634108,0.531365527380379,3,3,0
36,19,5598,2,4,0.0,1295,18,55,6893,Spain,12,-2.1200499998533773,-1.182523872135743,1,0,1
5,8,0,1,1,0.0,0,0,13,0,US,319,1.0016784193366708,0.4321440952603711,3,3,0
12,9,15,17,10,100.0,0,0,21,15,France,22,-0.9654610709245133,1.1314519512251169,0,0,1
6,8,3,38,4,50.0,1,0,14,4,France,11,-0.6597551787109526,0.2420171629812639,1,0,1
5,8,1,0,1,0.0,0,0,13,1,Italy,359,0.5535200437268449,-0.6817660409749369,2,0,2
9,8,0,1,4,75.0,1,0,17,1,Italy,141,-0.34314184835864453,0.7293484978068591,0,0,1
9,10,34,3,9,77.0,1,0,19,35,Russia,15,-1.1288032218658555,0.1699465205873702,1,0,1
5,8,2,0,1,0.0,2,0,13,4,Italy,496,0.18463522175098804,-1.1962853097811714,2,0,2
4,8,17,3,4,100.0,0,0,12,17,Italy,11,-0.31776099963470966,0.7000260222724353,0,0,1
6,34,4,1,8,87.0,20,32,40,24,France,22,-1.7120718007174087,-0.43583013913008967,1,0,1
5,8,0,2,1,0.0,0,0,13,0,France,13,0.9883603998147025,0.4497274122303117,3,3,0
12,8,0,0,17,70.0,0,0,20,0,France,14,0.4225150344085692,1.4647578170412683,0,3,0
5,8,1,0,9,100.0,0,0,13,1,UK,11,-0.0869183563803145,0.6660440580259187,0,0,1
6,8,0,0,3,100.0,0,0,14,0,France,13,0.5493295683121103,1.4815984785409098,0,3,0
12,9,462,1,2,0.0,1,5,21,463,Germany,14,-1.3294923966629941,-0.9804597596433872,1,0,1
9,9,26,19,4,75.0,0,24,18,26,Italy,11,-1.0731349953236609,0.054256117877734,1,0,1
12,8,1,1,11,100.0,0,0,20,1,Germany,146,-0.6153943334097405,1.2576900939994409,0,0,1
6,8,1,0,2,50.0,0,0,14,1,Italy,422,0.04249902019317822,0.2926772742375912,0,0,1
12,8,25,4,3,66.0,0,0,20,25,France,13,-0.5891148252433532,0.7138299974270528,0,0,1
10,8,30,2,7,57.0,0,2,18,30,UK,11,-0.8350730390434544,0.1735640847121622,1,0,1
16,8,0,7,14,92.0,0,0,24,0,Sweden,15,0.080485302656856,1.8979436223032733,0,3,0
6,8,0,0,1,0.0,0,0,14,0,Spain,362,1.155292251138641,0.2014957695955506,3,3,0
6,8,0,1,1,0.0,0,0,14,0,France,696,0.9273691142100399,0.5024147429299874,3,3,0
17,4,0,6,8,100.0,0,0,21,0,UK,23,0.287645904401256,2.2764687843498517,0,3,0
9,17,174,11,4,100.0,38,0,26,212,Italy,11,-1.6023036779031792,0.31687260755565155,1,0,1
5,11,2,1,1,0.0,0,1,16,2,France,132,-0.3386009863437444,-0.9120241313795615,2,0,2
15,9,2,1,1,0.0,0,0,24,2,France,330,-0.22454942415524345,-0.1595373422285842,2,0,2
5,8,37,6,3,100.0,1,0,13,38,Italy,13,-0.7932253199968413,0.3107462559827412,1,0,1
4,10,4,0,2,0.0,10,2,14,14,UK,32,-0.6658843078971143,-1.3532209143079255,1,0,1
4,8,0,0,1,0.0,0,0,12,0,France,675,1.3419139293825872,0.025257607180264305,3,3,0
10,8,85,2,2,50.0,0,2,18,85,UK,227,-0.8461707776381698,0.02146029996832319,1,0,1
6,8,0,0,1,0.0,0,0,14,0,Italy,615,1.155292251138641,0.2014957695955506,3,3,0
3,8,0,0,1,0.0,0,0,11,0,France,504,1.8211872325051166,-0.5087243978983329,3,3,3
24,8,27,113,30,76.0,9,1,32,36,Italy,11,-1.5273446441143483,0.1169717188515499,1,0,1
7,8,1,0,1,0.0,3,0,15,4,France,604,0.05923241332757292,-1.0611665483421342,2,0,2
7,8,1,1,1,0.0,0,0,15,1,Netherlands,230,0.19154399234241656,-0.25435818846141495,2,0,2
5,8,0,0,1,0.0,0,0,13,0,France,683,1.2296015562652718,0.13122512192593447,3,3,0
12,8,0,0,2,0.0,0,0,20,0,Sweden,12,0.6637085942019055,0.9430577206399767,3,3,0
10,8,0,7,6,100.0,0,0,18,0,France,31,0.0885396793411447,2.040465449876684,0,3,0
6,9,4,2,1,0.0,11,0,15,15,Pologne,16,-0.40923810857917303,-0.9412986555060961,2,0,2
9,8,0,20,6,83.0,0,0,17,0,US,14,0.23603095546124445,1.7235201648017486,0,3,0
7,11,1,7,1,0.0,0,1,18,1,Netherlands,110,-0.4362576516620476,-0.7366922764354409,2,0,2
5,8,0,1,1,0.0,0,2,13,0,France,696,0.7226642238561171,-0.07618661131074773,3,3,0
4,8,0,0,1,0.0,0,0,12,0,UK,693,1.3419139293825872,0.025257607180264305,3,3,0
4,8,0,2,1,0.0,0,0,12,0,France,45,1.1006727729320178,0.3437598974846417,3,3,0
7,8,2,0,2,100.0,0,0,15,2,Netherlands,18,-0.19949961958343915,0.6596989284472347,0,0,1
11,8,0,0,7,28.0,0,0,19,0,France,279,0.4825187008438948,1.3688490298806162,0,3,0
5,8,1,8,3,100.0,0,0,13,1,France,43,-0.3258957209319002,0.9593672405966007,0,0,1
7,8,0,0,2,100.0,1,1,15,1,UK,186,-0.42379713323142254,0.14486799896908348,1,0,1
4,8,7,4,2,100.0,0,0,12,7,France,11,-0.2613438659108315,0.7054942464076901,0,0,1
5,8,3,0,1,0.0,14,0,13,17,France,73,0.11223392418948361,-1.291245463135815,2,0,2
6,8,41,1,1,0.0,138,17,14,179,Germany,13,-0.6657399718567697,-1.6976429580197772,2,0,2
10,8,0,0,2,100.0,0,0,18,0,UK,633,0.39643275215540924,1.6096760028790886,0,3,0
9,8,0,0,4,75.0,0,0,17,0,France,405,0.5461689132804569,1.3030574567073048,0,3,0
5,8,8,2,1,0.0,1,1,13,9,Sweden,46,-0.35910138861522545,-1.4046695393385171,2,0,2
9,8,1,2,4,0.0,0,1,17,1,France,31,-0.4679743058472251,-0.06291472060264316,1,0,1
8,9,3,0,1,0.0,0,0,17,3,France,23,0.1388119009388316,-0.6243758545170094,2,0,2
6,9,1,0,2,100.0,0,0,15,1,France,218,-0.3194831156384512,0.5945504753330692,0,0,1
18,10,11,0,7,100.0,3,5,28,14,France,33,-1.423071999352017,-0.21135995723380188,1,0,1
6,8,1,0,1,0.0,0,0,14,1,France,386,0.4792107386002136,-0.6114953933053205,2,0,2
12,30,196,3,6,66.0,378,27,42,574,Netherlands,15,-2.0142489873757965,-0.6444720082353804,1,0,1
6,8,1,3,5,100.0,0,0,14,1,Spain,28,-0.39384260081718986,1.0323340151490046,0,0,1
7,8,64,0,2,100.0,0,0,15,64,France,84,-0.35442954365524776,0.47348528019968084,0,0,1
11,9,32,0,1,0.0,465,2,20,497,UK,17,-0.828959666822376,-1.8780043800673607,2,0,2
6,8,0,0,1,0.0,0,0,14,0,Italy,202,1.155292251138641,0.2014957695955506,3,3,0
5,8,0,0,1,0.0,0,0,13,0,Swiss,501,1.2296015562652718,0.13122512192593447,3,3,0
12,8,0,1,1,0.0,0,0,20,0,Spain,122,0.7083999974036679,0.7085848164636473,3,3,0
4,8,0,0,1,0.0,0,0,12,0,France,506,1.3419139293825872,0.025257607180264305,3,3,0
7,8,0,1,5,100.0,0,0,15,0,France,45,0.2444233102386702,1.8725926251089524,0,3,0
6,8,11,0,1,0.0,0,0,14,11,France,12,0.3817862166524586,-0.7285452914177818,2,0,2
5,8,3,0,1,0.0,7,0,13,10,Italy,545,0.139149349969474,-1.25543279671788,2,0,2
19,8,0,5,6,50.0,0,0,27,0,Italy,419,0.09918917443395478,1.8268087059064497,0,3,0
7,9,214,0,1,0.0,2,4,16,216,Sweden,11,-0.6512863851990424,-1.907000711341262,2,0,2
6,8,0,0,2,100.0,0,0,14,0,France,14,0.5649709224492977,1.4508801831986475,0,3,0
4,8,0,1,3,100.0,0,0,12,0,Italy,11,0.5080281096274553,1.606279289460061,0,3,0
3,8,1,0,2,100.0,0,0,11,1,Italy,629,0.5547843912773466,-0.0723311471961071,0,0,3
6,8,0,0,2,0.0,0,0,14,0,France,216,0.8826777110082775,0.736887647106316,3,3,0
4,8,0,0,1,0.0,0,0,12,0,Bahamas,590,1.3419139293825872,0.025257607180264305,3,3,0
10,9,23,2,2,0.0,11,0,19,34,Germany,183,-0.8852675175361194,-0.3349760386807538,1,0,2
3,8,0,0,2,100.0,0,0,11,0,France,424,1.2308659038157737,0.7406600157047639,3,3,3
53,9,3,5,106,98.0,0,0,62,3,France,11,-1.1392846847849165,1.3402664853136212,0,0,1
4,8,1,0,1,0.0,0,0,12,1,France,345,0.6658324168441598,-0.7877335557206069,2,0,2
5,8,0,1,1,0.0,0,0,13,0,US,534,1.0016784193366708,0.4321440952603711,3,3,0
8,8,38,3,9,77.0,1,3,16,39,Netherlands,12,-1.1328469008243736,-0.32359081942577855,1,0,1
5,11,8,1,4,75.0,3,0,16,11,Italy,16,-0.9352429643601543,-0.0023207876489933278,1,0,1
6,8,0,0,1,0.0,0,0,14,0,UK,616,1.155292251138641,0.2014957695955506,3,3,0
12,11,6,8,3,100.0,5,2,23,11,Grèce,11,-1.6016997184183528,0.05663947723569331,1,0,1
9,8,89,0,2,100.0,3,21,17,92,US,76,-1.112426714702752,-0.5379247966493099,1,0,1
6,8,2,4,3,0.0,0,0,14,2,France,13,-0.09487109600586165,0.25975293284242296,0,0,1
7,8,1,1,1,0.0,16,0,15,17,Germany,211,-0.22936530518328024,-0.8406433349588515,2,0,2
6,8,0,1,1,0.0,0,0,14,0,France,251,0.9273691142100399,0.5024147429299874,3,3,0
7,8,1,0,1,0.0,1,0,15,2,Italy,120,0.08904359880234995,-1.02139138788443,2,0,2
8,9,66,1,2,50.0,1,8,17,67,US,11,-1.2874971660998844,-0.592145662283952,1,0,1
53,9,4,38,50,68.0,3,0,62,7,Spain,240,-1.4967394106488556,0.8079038912013565,1,0,1
11,8,1,2,3,100.0,0,0,19,1,France,12,-0.5634541607694072,1.171065418112922,0,0,1
3,8,0,7,1,0.0,0,0,11,0,UK,83,1.5510304251928342,-0.15204578162784912,3,3,3
25,26,876,7,5,100.0,15,12,51,891,France,11,-2.232144805064233,-0.16997358623909686,1,0,1
3,8,0,1,1,0.0,0,0,11,0,Îles Canaries,106,1.5932640955765163,-0.20780542456389617,3,3,3
3,8,22,0,2,100.0,25,1,11,47,UK,303,-0.23265546333019754,-1.2653611052588758,2,0,3
10,10,7,1,3,100.0,8,1,20,15,UK,18,-1.4849771582049658,-0.04014435957858482,1,0,1
4,8,0,0,1,0.0,0,0,12,0,France,34,1.3419139293825872,0.025257607180264305,3,3,0
11,8,33,0,3,100.0,4,1,19,37,UK,103,-1.081457369575272,-0.2991074063690129,1,0,1
9,8,1,5,8,100.0,1,0,17,2,US,34,-0.8899249208509303,0.7404834105671804,1,0,1
22,11,432,3,9,70.0,181,37,33,613,Netherlands,12,-1.9201841274998186,-0.5839234774974559,1,0,1
5,8,1,0,1,0.0,0,0,13,1,UK,365,0.5535200437268449,-0.6817660409749369,2,0,2
47,8,4,9,63,98.0,1,0,55,5,Italy,12,-1.2629581136145587,0.8860397887452562,1,0,1
6,8,0,3,5,100.0,0,0,14,0,Italy,13,0.28223891172123733,1.8453251780498752,0,3,0
6,8,12,0,2,100.0,0,0,14,12,UK,73,-0.21271651577544448,0.5158092335363887,0,0,1
8,8,48,0,1,0.0,29,2,16,77,France,11,-0.4588919160034242,-1.7666628169816614,2,0,2
3,8,0,0,1,0.0,0,0,11,0,UK,233,1.8211872325051166,-0.5087243978983329,3,3,3
3,8,2,0,1,0.0,0,0,11,2,France,291,1.1164602998015765,-1.3561238841592147,2,0,3
4,8,0,0,1,0.0,0,0,12,0,France,696,1.3419139293825872,0.025257607180264305,3,3,0
5,8,0,0,1,0.0,0,0,13,0,France,581,1.2296015562652718,0.13122512192593447,3,3,0
8,8,0,2,3,100.0,0,0,16,0,France,341,0.2025257180710777,1.8995101046240048,0,3,0
5,8,1,1,1,0.0,0,0,13,1,Italy,224,0.32559690679824355,-0.3808470676404999,2,0,2
7,8,16,4,7,100.0,0,0,15,16,Germany,11,-0.5857327883108366,0.9784034177755042,0,0,1
4,8,1,0,1,0.0,0,0,12,1,Spain,157,0.6658324168441598,-0.7877335557206069,2,0,2
3,9,0,0,1,0.0,0,0,12,0,Italy,557,1.5244381286479025,-0.4789970662655853,3,3,3
4,8,13,13,5,100.0,0,0,12,13,France,16,-0.3471998073981466,0.7765085708239438,0,0,1
4,8,0,0,1,0.0,0,0,12,0,UK,372,1.3419139293825872,0.025257607180264305,3,3,0
10,8,4,5,7,71.0,2,0,18,6,Italy,71,-0.8278735849015473,0.3515273399926286,1,0,1
5,8,2,6,3,100.0,1,0,13,3,Monaco,11,-0.671493779625251,0.4568858398205163,0,0,1
30,8,16,13,33,96.0,97,1,38,113,Germany,12,-1.6035536384263374,0.05885720409122632,1,0,1
6,8,1,0,1,0.0,0,0,14,1,US,239,0.4792107386002136,-0.6114953933053205,2,0,2
4,8,0,0,1,0.0,0,0,12,0,France,285,1.3419139293825872,0.025257607180264305,3,3,0
17,8,0,3,14,93.0,0,0,25,0,US,11,0.08861701045650812,1.8836201771215257,0,3,0
4,8,24,7,1,0.0,8,3,12,32,UK,13,-0.3797719483451317,-1.6160073351375925,2,0,2
10,8,0,2,3,0.0,0,0,18,0,Italy,11,0.45725703012663194,1.2449040524333979,0,3,0
4,8,1,2,2,0.0,0,0,12,1,France,117,0.15197672026322676,0.06616061209453634,2,0,1
4,8,3,2,8,87.0,120,7,12,123,UK,11,-0.8987338287490427,-0.7164690091526064,1,0,1
10,8,0,0,1,0.0,0,0,18,0,US,606,0.9867540808447524,0.3602915892759919,3,3,0
19,38,331,1,1,0.0,10,31,57,341,UK,11,-1.5384341165752777,-1.4938260265248202,1,0,2
5,9,5,0,2,100.0,0,0,14,5,Italy,20,-0.3205388812844259,0.452989821637173,0,0,1
9,19,38,1,3,100.0,1,0,28,39,France,59,-1.4150424841710174,0.42635483415527786,1,0,1
4,8,0,0,1,0.0,0,0,12,0,Italy,645,1.3419139293825872,0.025257607180264305,3,3,0
20,9,0,1,1,0.0,0,0,29,0,France,353,0.42546563746166716,0.7393703873834587,3,3,0
9,8,1,0,1,0.0,0,0,17,1,UK,679,0.3390547632217085,-0.47935802887534246,2,0,2
3,8,0,0,1,0.0,0,0,11,0,France,397,1.8211872325051166,-0.5087243978983329,3,3,3
3,8,0,1,3,0.0,0,0,11,0,France,497,1.305008201308965,0.3583047482891319,3,3,3
7,8,0,0,7,100.0,0,0,15,0,France,523,0.4628210773959797,1.5903806715959738,0,3,0
5,8,1,1,3,66.0,0,0,13,1,Pologne,125,-0.1304636233331419,0.56237578219339,0,0,1
4,8,2,0,1,0.0,0,0,12,2,France,389,0.6371869966790462,-0.8221418790806176,2,0,2
3,8,55,0,1,0.0,21,3,11,76,Croatie,16,0.30845137385526566,-2.5843052949238126,2,0,3
3,8,0,0,1,0.0,0,0,11,0,France,300,1.8211872325051166,-0.5087243978983329,3,3,3
6,8,0,0,7,85.0,0,0,14,0,France,30,0.6645625747902612,1.2150460854149583,0,3,0
4,8,3,0,1,0.0,1,0,12,4,Spain,509,0.29885243921697485,-1.2974811411765397,2,0,2
6,8,55,4,3,100.0,0,0,14,55,France,12,-0.5601322743026976,0.7963597466377704,0,0,1
5,8,0,0,1,0.0,0,0,13,0,France,637,1.2296015562652718,0.13122512192593447,3,3,0
5,8,7,1,4,50.0,0,0,13,7,France,13,-0.21632579634800503,0.47777413573459165,0,0,1
5,8,0,0,1,0.0,0,0,13,0,France,397,1.2296015562652718,0.13122512192593447,3,3,0
7,8,0,0,1,0.0,0,0,15,0,France,578,1.0955486418094451,0.2577140011050194,3,3,0
5,8,6,0,3,33.0,0,0,13,6,France,359,0.02946094315632781,0.1616532718899434,0,0,1
7,9,102,8,9,100.0,222,28,16,324,Austria,11,-1.6752688187735343,-0.3725359852273812,1,0,1
12,8,2,8,4,75.0,0,15,20,2,France,11,-0.826469971586752,0.3156522449404182,1,0,1
5,8,0,4,1,0.0,0,0,13,0,France,11,0.9724210360918613,0.47077159858066026,3,3,0
13,8,12,3,16,81.0,1,0,21,13,Italy,40,-0.9461653730581268,0.4344827188784648,1,0,1
10,8,0,1,4,75.0,0,0,18,0,UK,497,0.2898635814364722,1.6306348852922057,0,3,0
50,8,0,44,64,93.0,0,0,58,0,Croatie,11,-0.2607252720475507,2.28340179195477,0,3,0
4,10,28,2,1,0.0,5,0,14,33,Italy,19,-0.40709179947379437,-1.1207428433733315,2,0,2
3,8,0,0,1,0.0,0,0,11,0,Italy,125,1.8211872325051166,-0.5087243978983329,3,3,3
3,8,11,0,2,50.0,0,0,11,11,UK,230,0.6109694796118993,-0.5345927913687537,2,0,3
6,8,14,2,3,0.0,10,0,14,24,Germany,24,-0.5246510402265494,-0.37365759257120806,2,0,1
6,8,0,0,1,0.0,0,0,14,0,France,336,1.155292251138641,0.2014957695955506,3,3,0
3,8,0,0,1,0.0,0,0,11,0,France,506,1.8211872325051166,-0.5087243978983329,3,3,3
3,10,9,0,2,0.0,94,1,13,103,Italy,11,-0.35713384289112743,-1.9338091181359407,2,0,3
8,8,7,0,6,83.0,0,0,16,7,France,22,-0.190586991342436,0.3932207603676119,0,0,1
3,8,2,1,1,0.0,0,0,11,2,Italy,118,0.8885371628729747,-1.0552049108247779,2,0,3
6,8,1,1,4,75.0,0,0,14,1,UK,262,-0.21767976080806667,0.6588479027108924,0,0,1
6,8,8,0,1,0.0,16,4,14,24,France,15,-0.2854809114343261,-1.7905502367823243,2,0,2
13,8,0,9,10,100.0,0,0,21,0,France,21,-0.004829967595105737,2.147253892939092,0,3,0
17,9,15,3,2,100.0,11,2,26,26,Spain,12,-1.5909130512042893,0.013666040458296797,1,0,1
3,8,0,0,1,0.0,0,0,11,0,Italy,26,1.8211872325051166,-0.5087243978983329,3,3,3
3,8,0,0,1,0.0,0,0,11,0,France,475,1.8211872325051166,-0.5087243978983329,3,3,3
13,9,19,18,3,100.0,0,0,22,19,Sweden,11,-0.9564594215040272,1.0622163962290856,0,0,1
5,8,1,0,1,0.0,0,0,13,1,UK,692,0.5535200437268449,-0.6817660409749369,2,0,2
3,8,0,0,1,0.0,0,0,11,0,France,609,1.8211872325051166,-0.5087243978983329,3,3,3
10,9,70,5,10,90.0,1,0,19,71,Italy,12,-1.1473873482467236,0.19778158617087233,1,0,1
5,9,2,0,2,0.0,0,0,14,2,France,97,0.03440656068701126,-0.21628255937530658,2,0,2
6,9,8,0,1,0.0,0,0,15,8,France,60,0.18537298777217573,-0.7575141363611492,2,0,2
100,450,544,82,41,90.0,114,9,550,658,Italy,11,-2.6775862758388302,-0.037536741969381233,1,0,1
4,8,0,0,2,100.0,0,0,12,0,France,356,0.7515926006932439,1.2746420207833618,0,3,0
8,8,0,22,15,100.0,0,0,16,0,US,13,0.09292441704064636,2.0784611730337295,0,3,0
18,8,4,202,17,92.3,31,6,26,35,Swiss,11,-1.4909633412211876,0.02610596197741424,1,0,1
3,8,0,0,1,0.0,0,0,11,0,France,425,1.8211872325051166,-0.5087243978983329,3,3,3
6,8,0,25,6,66.0,2,0,14,2,Germany,12,-0.3103401932953504,0.6801873007754627,0,0,1
5,8,0,0,1,0.0,0,0,13,0,France,412,1.2296015562652718,0.13122512192593447,3,3,0
7,8,3,0,4,100.0,3,0,15,6,Netherlands,74,-0.5876057885567996,0.20161882030992484,0,0,1
8,8,3,0,3,0.0,0,0,16,3,France,336,0.040600378298620156,0.0002257766445449651,2,0,2
4,8,0,0,1,0.0,0,0,12,0,France,676,1.3419139293825872,0.025257607180264305,3,3,0
7,9,0,0,1,0.0,24,2,16,24,Italy,152,-0.16307124212578622,-1.334621827062952,2,0,2
5,8,1,0,2,100.0,5,1,13,6,Germany,25,-0.6809077708378573,-0.4474179791415445,1,0,1
4,8,8,0,1,0.0,0,0,12,8,France,18,0.5803671915654436,-0.8904137538117285,2,0,2
9,8,17,16,15,90.0,4,1,17,21,UK,12,-1.1977947631944175,-0.14179447315163507,1,0,1
4,8,1,0,2,0.0,0,0,12,1,Swiss,251,0.39321787671379643,-0.252341678209841,2,0,2
4,8,76,1,1,0.0,25,5,12,101,Sweden,52,-0.4289575284082984,-1.7925289757426248,2,0,2
14,8,2,0,4,75.0,0,0,22,2,UK,149,-0.2738258002863445,0.5642672660016399,0,0,1
5,8,2,0,4,25.0,0,0,13,2,Italy,260,0.06456398297820748,0.23379543284261659,0,0,1
6,8,0,12,11,83.0,1,1,14,1,US,11,-0.5613047967802702,0.25298252980057284,1,0,1
6,9,2,1,1,0.0,0,0,15,2,France,624,0.014269655957177057,-0.38832328829560153,2,0,2
4,8,30,1,3,100.0,0,0,12,30,Austria,11,-0.3130964422352483,0.618937984189427,0,0,1
6,8,21,2,15,100.0,0,1,14,21,France,13,-0.8167354337891122,0.4502855711727639,0,0,1
3,8,1,4,1,0.0,0,0,11,1,Luxembourg,122,0.8879251997932789,-0.9821690841444782,2,0,3
8,8,2,5,6,50.0,0,0,16,2,UK,356,-0.39166208861630486,0.7779847254774347,0,0,1
3,8,1,0,1,0.0,0,0,11,1,US,288,1.1451057199666899,-1.3217155607992042,2,0,3
6,8,3,0,1,0.0,0,0,14,3,UK,100,0.4344189663566338,-0.6652937319871997,2,0,2
8,9,1,0,1,0.0,0,0,17,1,Netherlands,547,0.18360367318241164,-0.5705775158351305,2,0,2
4,8,2,1,1,0.0,0,0,12,2,France,330,0.4092638597504449,-0.5212229057461806,2,0,2
4,8,0,0,1,0.0,0,0,12,0,US,542,1.3419139293825872,0.025257607180264305,3,3,0
7,8,7,6,5,80.0,6,1,15,13,France,360,-1.0286255053936,-0.30147255561022873,1,0,1
7,8,0,7,4,100.0,0,0,15,0,Italy,14,0.20953395496084304,1.9139286549403058,0,3,0
3,8,7,2,1,0.0,8,0,11,15,France,88,0.4599201735950525,-1.6126240730285655,2,0,3
3,8,3,6,1,0.0,0,0,11,3,Italy,11,0.8341364923231916,-1.0240890828385871,2,0,3
3,9,6,0,1,0.0,0,2,12,6,Italy,11,0.496084978984498,-1.8883040447596102,2,0,3
6,8,11,2,2,0.0,4,5,14,15,Denmark,21,-0.7727465636770203,-0.9015359468960568,1,0,1
12,12,172,3,1,0.0,104,11,24,276,Denmark,11,-1.251087519425668,-1.585532877879888,1,0,2
5,8,2,0,2,0.0,0,0,13,2,Germany,614,0.25226008343136763,-0.1807824868241817,2,0,2
3,8,19,0,1,0.0,0,0,11,19,France,22,1.022855355689288,-1.4686481914360257,2,0,3
48,28,346,3,19,89.0,1075,54,76,1421,Italy,11,-2.3232396482845767,-0.4817966568460006,1,0,1
40,8,0,12,37,94.0,0,0,48,0,Italy,11,-0.1621032002404339,2.1638749599642453,0,3,0
11,8,3,1,11,63.0,2,0,19,5,Italy,129,-0.8223527539657693,0.3660054246125679,1,0,1
4,8,0,0,1,0.0,0,0,12,0,France,203,1.3419139293825872,0.025257607180264305,3,3,0
9,8,0,1,1,0.0,0,0,17,0,US,664,0.7872131388315342,0.6345521073599655,3,3,0
27,8,0,1,24,90.9,0,0,35,0,Italy,38,-0.005849207185863829,1.9781123779666645,0,3,0
3,9,30,0,1,0.0,1,1,12,31,Netherlands,13,0.11854297325900696,-2.4036513547367067,2,0,3
36,8,45,5,22,69.2,0,0,44,45,France,14,-0.9383968005855378,1.045293613502264,0,0,1
12,8,26,2,4,60.0,0,2,20,26,France,21,-0.8618702008545693,0.19756544010978236,1,0,1
9,8,0,8,9,88.0,0,0,17,0,France,16,0.24160976783449478,1.7270271504861296,0,3,0
9,12,142,0,1,0.0,34,23,21,176,France,13,-0.9265824873659059,-1.9518639660848622,2,0,2
3,8,0,1,1,0.0,0,0,11,0,France,27,1.5932640955765163,-0.20780542456389617,3,3,3
5,8,0,0,1,0.0,0,0,13,0,UK,32,1.2296015562652718,0.13122512192593447,3,3,0
57,8,45,123,92,74.0,6,2,65,51,UK,11,-1.7954199415449161,0.35305981365394934,1,0,1
16,10,263,3,23,86.0,5,1,26,268,Spain,15,-1.6898678129139295,-0.3010719412451216,1,0,1
5,8,90,3,6,0.0,0,1,13,90,France,11,-0.4785060643197754,-0.47534960180944713,2,0,1
5,8,1,0,1,0.0,1,4,13,2,US,513,-0.06835112475792907,-1.6788632283642646,2,0,2
4,8,1,0,1,0.0,0,0,12,1,France,31,0.6658324168441598,-0.7877335557206069,2,0,2
15,21,480,3,5,83.0,7,19,36,487,UK,11,-1.9040258573580275,-0.5400457901908728,1,0,1
3,9,0,1,1,0.0,0,0,12,0,US,333,1.296514991719301,-0.17807809293114837,3,3,3
21,31,24,0,5,100.0,1,0,52,25,US,146,-1.4032661424829391,0.3431006172187739,1,0,1
102,8,0,0,87,98.0,0,0,110,0,US,68,-0.0666134198028915,2.001661241584226,0,3,0
9,8,0,20,2,50.0,0,0,17,0,US,11,0.28387983931415844,1.6266829263209168,0,3,0
17,14,113,4,1,0.0,210,77,31,323,US,11,-1.408165744117921,-1.6072276725185553,1,0,2
7,8,1,7,3,0.0,0,0,15,1,US,23,-0.13894557230881607,0.3675116273276601,0,0,1
3,9,55,1,1,0.0,1,0,12,56,France,23,0.12722989346110394,-1.6524133328392863,2,0,3
6,8,1,0,1,0.0,0,0,14,1,Germany,690,0.4792107386002136,-0.6114953933053205,2,0,2
10,8,183,3,3,66.0,11,3,18,194,Italy,11,-1.2830315545296118,-0.5006841703277602,1,0,1
83,8,4,56,57,98.0,0,0,91,4,Taiwan,11,-1.071436172994569,1.4776292731716916,0,0,1
7,8,0,0,1,0.0,0,0,15,0,France,96,1.0955486418094451,0.2577140011050194,3,3,0
9,11,59,5,9,90.0,7,1,20,66,Netherlands,43,-1.5172382260949273,-0.36230600792733986,1,0,1
3,8,0,0,1,0.0,0,0,11,0,France,471,1.8211872325051166,-0.5087243978983329,3,3,3
12,8,3,8,12,84.0,1,0,20,4,UK,35,-0.8888490493477665,0.4945406473959138,1,0,1
3,8,0,1,1,0.0,0,0,11,0,Hong Kong,92,1.5932640955765163,-0.20780542456389617,3,3,3
4,8,0,0,1,0.0,0,0,12,0,France,13,1.3419139293825872,0.025257607180264305,3,3,0
3,8,4,0,1,0.0,0,1,11,4,UK,67,0.8204064895146441,-1.877841784287453,2,0,3
6,8,3,1,3,66.0,0,0,14,3,UK,53,-0.24956470070335288,0.5788480911811269,0,0,1
5,7,1,3,1,0.0,0,0,12,1,France,344,0.6504748930152768,-0.29073758071326666,2,0,2
7,8,0,0,1,0.0,0,0,15,0,Spain,474,1.0955486418094451,0.2577140011050194,3,3,0
4,8,0,0,1,0.0,0,0,12,0,UK,247,1.3419139293825872,0.025257607180264305,3,3,0
8,9,32,0,9,77.0,4,13,17,36,Finland,20,-1.113665045098322,-0.782164940866109,1,0,1
5,8,0,0,1,0.0,0,0,13,0,Italy,624,1.2296015562652718,0.13122512192593447,3,3,0
9,8,0,3,4,50.0,0,0,17,0,Italy,13,0.3030368617308947,1.6178271833149747,0,3,0
33,2,9,1,14,85.0,5,0,35,14,US,15,-0.8071071870967603,0.6886697140736623,0,0,1
9,8,0,0,2,0.0,0,0,17,0,Netherlands,421,0.7425217356297725,0.8690250115362941,3,3,0
4,8,0,0,1,0.0,0,0,12,0,France,341,1.3419139293825872,0.025257607180264305,3,3,0
3,8,0,1,1,0.0,0,0,11,0,France,321,1.5932640955765163,-0.20780542456389617,3,3,3
3,8,1,0,2,100.0,0,0,11,1,France,18,0.5547843912773466,-0.0723311471961071,0,0,3
10,8,8,1,11,72.0,0,0,18,8,France,358,-0.5024923421326225,0.7751737733384259,0,0,1
4,8,0,0,1,0.0,0,0,12,0,France,372,1.3419139293825872,0.025257607180264305,3,3,0
5,9,3,0,2,100.0,1,0,14,4,France,115,-0.62163478533404,0.022370714621102628,1,0,1
10,12,0,14,4,50.0,20,2,22,20,UK,151,-1.1351191527894833,0.09053678931010906,1,0,1
8,8,0,0,5,60.0,0,5,16,0,UK,11,0.2822913766256825,0.7343434759183789,0,3,0
4,9,53,2,2,100.0,1,0,13,54,France,433,-0.901900463685672,0.10827034986164438,1,0,1
17,5,40,7,15,82.0,0,0,22,40,France,11,-0.45531312181274297,0.9993412853271386,0,0,1
4,8,12,0,4,50.0,0,0,12,12,Singapour,130,0.10197822190383364,0.044510949022623265,0,0,1
3,8,0,0,1,0.0,0,0,11,0,UK,26,1.8211872325051166,-0.5087243978983329,3,3,3
9,8,1,1,1,0.0,0,0,17,1,US,631,0.1111316262931074,-0.1784390555409058,2,0,2
10,8,0,1,1,0.0,0,0,18,0,Spain,451,0.7588309439161514,0.6612105626104289,3,3,0
20,8,7,1,15,43.0,0,0,28,7,UK,395,-0.6619187791261687,0.9402379570835138,0,0,1
17,11,2,0,5,80.0,2,3,28,4,Austria,45,-1.2158240709048522,-0.4732901472744129,1,0,1
4,8,0,0,1,0.0,0,0,12,0,France,322,1.3419139293825872,0.025257607180264305,3,3,0
3,8,0,0,1,0.0,0,0,11,0,Portugal,24,1.8211872325051166,-0.5087243978983329,3,3,3
8,10,116,7,3,0.0,23,0,18,139,Italy,70,-1.0334135549920938,-0.44286115299761075,1,0,2
7,8,17,1,5,80.0,0,0,15,17,Romania,59,-0.4047530112950314,0.5925650252793683,0,0,1
5,10,65,3,1,0.0,1,1,15,66,Italy,14,-0.7733634385664047,-1.533146260378728,2,0,2
5,10,0,0,1,0.0,0,0,15,0,France,50,0.921040692387993,0.10803644771039539,3,3,0
3,8,1,2,1,0.0,0,0,11,1,UK,462,0.9038645635161199,-1.003213270494827,2,0,3
4,8,1,0,1,0.0,0,0,12,1,Italy,629,0.6658324168441598,-0.7877335557206069,2,0,2
7,11,38,0,1,0.0,3,2,18,41,France,37,-0.6706409769533882,-1.7789689501159018,2,0,2
5,10,0,6,11,100.0,0,0,15,0,Italy,11,0.007150418713093795,1.8215577047895564,0,3,0
8,8,0,0,1,0.0,0,0,16,0,Bulgaria,601,1.0497295573481782,0.3009051053742669,3,3,0
12,22,74,0,1,0.0,278,4,34,352,France,16,-1.1270701180062843,-1.8630935848048629,1,0,2
3,8,0,0,1,0.0,0,0,11,0,US,670,1.8211872325051166,-0.5087243978983329,3,3,3
4,9,19,3,1,0.0,1,2,13,20,UK,18,-0.5480211843842792,-1.5765650616073514,2,0,2
3,8,0,0,1,0.0,0,0,11,0,France,681,1.8211872325051166,-0.5087243978983329,3,3,3
16,8,0,2,4,100.0,1,0,24,1,France,31,-0.6485686475783509,1.2137929085886983,0,0,1
5,8,0,0,2,0.0,0,0,13,0,Germany,203,0.9569870161349087,0.6666169994366998,3,3,0
4,9,4,0,2,0.0,0,0,13,4,France,22,0.09111917742557095,-0.3338919712812749,2,0,2
3,8,32,0,1,0.0,0,0,11,32,France,577,0.9966863208054384,-1.5001109533613173,2,0,3
3,8,0,0,1,0.0,0,0,11,0,Italy,659,1.8211872325051166,-0.5087243978983329,3,3,3
6,8,7,0,2,100.0,15,2,14,22,Netherlands,160,-0.8574835224549961,-0.5112409810328941,1,0,1
31,8,0,5,9,88.0,0,0,39,0,Italy,68,-0.04607664143098682,1.9932196888208438,0,3,0
8,11,549,5,1,0.0,8,10,19,557,Germany,11,-1.1599617717079382,-1.6552374442231976,1,0,2
5,8,4,0,1,0.0,0,0,13,4,UK,33,0.4964576349158239,-0.7502897809590354,2,0,2
4,8,9,1,1,0.0,113,5,12,122,France,14,-0.40410958187096746,-1.7691648904742878,2,0,2
7,8,0,1,10,60.0,0,0,15,0,France,13,0.3752587175857239,1.572617994668159,0,3,0
3,9,0,0,1,0.0,0,0,12,0,France,688,1.5244381286479025,-0.4789970662655853,3,3,3
6,8,0,0,3,66.0,0,0,14,0,Belgium,230,0.6992317210072555,1.1447186194294403,0,3,0
6,8,0,0,1,0.0,0,0,14,0,UK,634,1.155292251138641,0.2014957695955506,3,3,0
11,8,0,0,2,100.0,0,0,19,0,France,169,0.3695098623567773,1.634835995367153,0,3,0
7,8,0,0,1,0.0,0,0,15,0,US,665,1.0955486418094451,0.2577140011050194,3,3,0
8,10,22,0,1,0.0,0,0,18,22,France,149,-0.015377835923388145,-0.7333791233103977,2,0,2
6,8,1,1,2,100.0,0,0,14,1,France,373,-0.33903372701773066,0.9388079936322136,0,0,1
16,8,0,25,9,100.0,0,0,24,0,US,131,-0.07236330328016062,2.2167052934796687,0,3,0
5,8,12,0,1,0.0,0,0,13,12,Netherlands,36,0.4519141180405298,-0.8038458277363246,2,0,2
6,9,33,0,1,0.0,3,2,15,36,UK,49,-0.49386039357793854,-1.8190261134240626,2,0,2
7,8,0,0,2,100.0,0,0,15,0,US,167,0.5052273131201019,1.5070984147081161,0,3,0
5,8,0,6,6,100.0,0,0,13,0,UK,19,0.3353665066740292,1.8061451828986383,0,3,0
3,8,0,0,1,0.0,0,0,11,0,France,528,1.8211872325051166,-0.5087243978983329,3,3,3
5,9,2,0,1,0.0,0,0,14,2,UK,505,0.3070211008173747,-0.7516744368860723,2,0,2
10,8,7,3,2,100.0,1,0,18,8,Sweden,26,-0.9287295165947874,0.5781522467088738,1,0,1
3,8,128,0,1,0.0,0,5,11,128,Denmark,39,0.6255807077090784,-2.1296373162163533,2,0,3
3,8,0,0,1,0.0,0,0,11,0,France,650,1.8211872325051166,-0.5087243978983329,3,3,3
15,9,4,0,1,0.0,0,7,24,4,Australia,79,-0.3271307179299176,-1.044939152033983,2,0,2
4,8,9,6,2,0.0,2,0,12,11,Belgium,133,-0.29344483769315144,-0.4771039149617166,2,0,1
53,61,1160,62,45,80.0,4,69,114,1164,US,11,-2.4378544749236792,-0.2225515280535931,1,0,1
8,10,16,0,3,0.0,134,10,18,150,UK,12,-1.0508703322963144,-1.344342239960657,1,0,1
10,8,16,0,1,0.0,0,0,18,16,Germany,13,0.1953807353113468,-0.5912321411992033,2,0,2
13,10,0,0,1,0.0,0,0,23,0,France,196,0.6797528745455498,0.34402878999043146,3,3,0
3,8,0,1,2,0.0,14,0,11,14,France,66,0.5622560726264175,-0.6747918997435306,2,0,3
4,8,0,0,1,0.0,0,0,12,0,US,352,1.3419139293825872,0.025257607180264305,3,3,0
5,8,0,0,1,0.0,1,0,13,1,France,191,0.5682139315547722,-0.7434028103089483,2,0,1
3,8,0,1,2,0.0,0,0,11,0,Italy,19,1.3206495554461524,0.3275864529468694,3,3,3
5,8,0,0,1,0.0,0,0,13,0,France,223,1.2296015562652718,0.13122512192593447,3,3,0
9,8,9,0,1,0.0,1113,66,17,1122,Spain,12,-0.6857308940786577,-2.0282767540163666,2,0,2
10,8,0,0,1,0.0,0,0,18,0,Spain,578,0.9867540808447524,0.3602915892759919,3,3,0
14,9,1,5,4,0.0,0,0,23,1,France,327,-0.5132810848652624,0.49146658120675235,0,0,1
11,8,1,1,1,0.0,1,0,19,2,Spain,584,-0.27459698888957584,-0.5927348338909564,2,0,2
26,44,1,0,9,53.0,0,0,70,1,France,210,-0.8973714619035345,0.6922614451751892,1,0,1
3,8,0,0,3,0.0,0,0,11,0,UK,34,1.5329313382375667,0.057385774954694956,3,3,3
4,8,8,3,2,100.0,0,0,12,8,Italy,130,-0.25980528189912944,0.688840417576197,0,0,1
43,16,31,0,3,100.0,2,2,59,33,US,12,-1.7045602441091279,-0.1227462701060719,1,0,1
34,9,46,25,27,96.0,0,0,43,46,France,12,-1.1579932089846978,1.0521913496202595,1,0,1
13,10,4,0,1,0.0,2,2,23,6,Sweden,550,-0.6670685192847318,-1.5190450744572714,2,0,2
23,8,2,1,1,0.0,1916,405,31,1918,Belgium,29,-1.3708485029598803,-1.90974115962293,1,0,2
9,8,338,6,1,0.0,224,14,17,562,US,11,-0.944678652122863,-1.6350018221306106,2,0,2
3,8,27,0,1,0.0,2,2,11,29,UK,17,0.3982703033518522,-2.463123579662126,2,0,3
4,10,32,50,4,75.0,0,0,14,32,Italy,11,-0.6129532041108731,0.4278525082221698,0,0,1
17,9,70,4,7,42.0,1,0,26,71,US,11,-1.2323213299469251,0.24507544586624871,1,0,1
3,8,3,3,1,0.0,1,0,11,4,Belgium,14,0.5282745975642749,-1.5015933884703085,2,0,3
23,22,28,23,60,96.4,139,6,45,167,UK,11,-2.030864664110141,-0.1434318309266738,1,0,1
125,500,7044,117,67,90.0,664,0,625,7708,Sweden,16,-2.8623349918944108,0.03353915404179909,1,0,1
4,8,0,0,1,0.0,0,0,12,0,UK,693,1.3419139293825872,0.025257607180264305,3,3,0
4,8,0,2,1,0.0,0,1,12,0,US,19,0.8330359512909928,-0.14384258601950806,3,3,0
18,9,1,2,6,83.0,0,0,27,1,France,12,-0.7290596037201725,0.9268935019406058,0,0,1
23,8,2,0,11,100.0,0,0,31,2,US,186,-0.557489908440533,1.0555631953795825,0,0,1
17,9,71,6,4,0.0,120,3,26,191,Swiss,15,-1.4546005421062174,-0.8096394300953453,1,0,1
4,8,0,1,1,0.0,0,0,12,0,Spain,640,1.1139907924539865,0.32617658051470094,3,3,0
74,161,151,7,13,92.0,23,0,235,174,Italy,12,-2.0743436131976347,0.476149160722818,1,0,1
7,9,1,0,1,0.0,0,1,16,1,UK,471,-0.04644977762886314,-1.094562176996819,2,0,2
4,8,2,0,2,0.0,1,0,12,3,Italy,12,0.04034419158814947,-0.745217323002244,2,0,2
5,9,19,1,2,100.0,1,4,14,20,Germany,44,-1.2139775531470125,-0.29528969190239657,1,0,1
3,8,32,5,2,100.0,1,0,11,33,UK,13,-0.17325357464431293,-0.35457229611954416,2,0,3
23,35,5,4,7,100.0,4,0,58,9,US,15,-1.6633188166896293,0.761067622360092,1,0,1
3,8,0,3,2,0.0,0,0,11,0,US,135,1.298721547599524,0.35653723739726095,3,3,3
7,8,3,3,6,50.0,0,2,15,3,UK,47,-0.6286379671373632,0.19074704900600162,1,0,1
9,17,56,4,2,100.0,3,4,26,59,Belgium,21,-1.7318624882713505,-0.15164677442623853,1,0,1
8,8,0,0,3,66.0,0,0,16,0,France,584,0.5936690272167927,1.244127955208157,0,3,0
16,22,20,0,2,100.0,14,2,38,34,US,33,-1.6017943564219306,-0.34568559662961634,1,0,1
8,8,41,1,2,100.0,50,1,16,91,Belgium,15,-1.2740726555592188,-0.2075358669861269,1,0,1
4,8,1,0,1,0.0,0,0,12,1,France,516,0.6658324168441598,-0.7877335557206069,2,0,2
3,8,0,0,1,0.0,1,0,11,1,Germany,263,1.1597996077946169,-1.3833523301332156,2,0,3
4,8,2,1,1,0.0,0,3,12,2,France,17,0.12322112172281925,-1.042358781577467,2,0,2
4,8,0,1,4,100.0,0,0,12,0,France,45,0.49813291291766687,1.6257126180795047,0,3,0
18,8,8,0,3,66.0,0,0,26,8,Spain,13,-0.37092216510845494,0.5197947572324569,0,0,1
4,8,5,0,1,0.0,5,1,12,10,Italy,362,-0.021915637797740927,-1.8544441447226938,2,0,2
19,10,14,54,12,83.3,108,20,29,122,Spain,22,-1.7730747147400183,-0.2722121867296807,1,0,1
12,8,90,4,6,33.0,0,0,20,90,Spain,244,-0.6740228046684784,0.6636645708017647,0,0,1
8,8,367,14,2,50.0,1,19,16,368,Romania,11,-1.27218677509102,-0.6061218071148817,1,0,1
4,8,0,2,2,100.0,0,0,12,0,France,15,0.5103514442426742,1.5931443110877386,0,3,0
11,8,1,2,4,100.0,0,0,19,1,Germany,64,-0.5733493574791956,1.190498746732366,0,0,1
5,8,0,0,1,0.0,0,0,13,0,France,366,1.2296015562652718,0.13122512192593447,3,3,0
4,8,0,0,1,0.0,0,0,12,0,France,260,1.3419139293825872,0.025257607180264305,3,3,0
3,8,5,0,1,0.0,0,4,11,5,Germany,48,0.7877740083730124,-1.9318270005398168,2,0,3
3,9,10,1,2,100.0,79,2,12,89,Bulgaria,12,-0.7831039298800401,-0.9773895660366976,1,0,3
4,8,0,0,1,0.0,0,0,12,0,France,418,1.3419139293825872,0.025257607180264305,3,3,0
4,8,0,0,2,0.0,0,0,12,0,Belgium,573,1.0692993892522238,0.5606494846910302,3,3,0
6,8,0,0,4,75.0,3,0,14,3,Belgium,227,-0.01310924661137792,0.24635202027021566,0,0,1
7,8,13,0,2,100.0,3,4,15,16,Germany,192,-0.9050327005277349,-0.44115041567777247,1,0,1
13,21,8,0,1,0.0,9,0,34,17,Spain,689,-0.6361161317408988,-1.066326807100267,2,0,2
4,8,0,0,2,50.0,0,0,12,0,France,103,0.9052022109755519,0.9294302747231762,3,3,0
3,8,4,3,1,0.0,2,0,11,6,UK,13,0.5035288893801596,-1.5335977979900883,2,0,3
12,8,0,0,7,100.0,0,0,20,0,UK,251,0.30359556991880365,1.7403325136201648,0,3,0
11,8,1,4,9,50.0,0,0,19,1,Spain,17,-0.46025963149056925,0.9146052484585813,0,0,1
4,8,0,4,4,60.0,0,0,12,0,France,32,0.620683870944265,1.32317642428156,0,3,0
8,10,176,8,7,100.0,28,1,18,204,France,11,-1.677307731708882,-0.19438276038089805,1,0,1
4,8,1,1,1,0.0,1,0,12,2,Sweden,83,0.10748574944689084,-0.9529288084747486,2,0,2
3,8,0,1,1,0.0,0,0,11,0,US,297,1.5932640955765163,-0.20780542456389617,3,3,3
28,8,83,34,51,100.0,25,8,36,108,UK,12,-1.8112899505307638,0.30698653839469653,1,0,1
5,8,0,1,1,0.0,0,0,13,0,France,16,1.0016784193366708,0.4321440952603711,3,3,0
4,8,0,0,2,100.0,0,0,12,0,France,659,0.7515926006932439,1.2746420207833618,0,3,0
4,8,0,1,2,0.0,0,0,12,0,Italy,223,0.8413762523236226,0.861568458025467,3,3,0
5,8,0,0,1,0.0,0,0,13,0,France,456,1.2296015562652718,0.13122512192593447,3,3,0
12,10,2,1,1,0.0,0,0,22,2,UK,455,-0.23567669089679155,-0.21922405105540246,2,0,2
6,4,0,1,2,100.0,0,0,10,0,France,260,1.0752976362297735,1.519814890481761,0,3,2
4,8,0,0,2,100.0,0,0,12,0,Belgium,51,0.7515926006932439,1.2746420207833618,0,3,0
7,8,1,0,1,0.0,0,0,15,1,Monaco,91,0.4194671292710177,-0.5552771617958517,2,0,2
4,8,0,5,7,100.0,0,0,12,0,UK,18,0.44696963561719677,1.704119885765245,0,3,0
8,14,2,3,1,0.0,12,3,22,14,Italy,11,-0.9728704365436373,-1.3374010866068118,1,0,2
18,9,4,9,18,100.0,3,1,27,7,France,15,-1.6118711353506476,0.32374034946139435,1,0,1
7,11,19,1,2,0.0,1,1,18,20,France,13,-1.1065904919041794,-0.8544040458738416,1,0,1
9,12,5,2,2,0.0,1,0,21,6,Italy,22,-0.8900930591179814,-0.22188395817823212,1,0,2
7,8,1,2,4,100.0,0,0,15,1,France,12,-0.4376319067158709,1.0627611660733292,0,0,1
11,8,0,11,3,66.0,0,0,19,0,Spain,17,0.22254819109211746,1.699962656382718,0,3,0
3,8,0,0,1,0.0,0,0,11,0,UK,12,1.8211872325051166,-0.5087243978983329,3,3,3
5,8,2,0,2,100.0,0,0,13,2,Italy,363,-0.06544670512761214,0.5332100492681497,0,0,1
4,8,0,1,1,0.0,0,0,12,0,France,339,1.1139907924539865,0.32617658051470094,3,3,0
4,8,3,0,1,0.0,0,5,12,3,Germany,292,0.32499631724885025,-1.3808894774096367,2,0,2
3,8,0,1,1,0.0,0,0,11,0,Italy,205,1.5932640955765163,-0.20780542456389617,3,3,3
58,48,593,39,47,93.0,66,1,106,659,Spain,11,-2.343329425443469,-0.07449351764060419,1,0,1
4,8,1,0,1,0.0,7,0,12,8,US,629,0.27779611677066807,-1.3303841786231878,2,0,2
4,8,6,5,6,83.0,1,0,12,7,France,120,-0.4738901777838602,0.018623862280760562,0,0,1
10,8,0,0,2,66.0,0,0,18,0,UK,132,0.5463349048505545,1.2727961437676194,0,3,0
5,8,2,4,4,100.0,0,0,13,2,UK,11,-0.3481637761479986,0.9229081498845817,0,0,1
4,8,37,1,5,60.0,0,0,12,37,France,17,-0.19062438678429083,0.29708597822367794,0,0,1
3,8,0,0,1,0.0,0,0,11,0,France,416,1.8211872325051166,-0.5087243978983329,3,3,3
10,9,20,5,6,33.0,1,8,19,21,Denmark,15,-1.3576870811565336,-0.35016376650576686,1,0,1
5,11,0,0,1,0.0,5,0,16,5,Germany,359,0.14382904173451438,-0.8267540963084896,2,0,2
167,8,0,25,125,100.0,0,0,175,0,US,22,-0.6182207728964431,2.8348482442054843,0,3,0
3,8,1,2,1,0.0,0,0,11,1,UK,71,0.9038645635161199,-1.003213270494827,2,0,3
6,11,6,13,6,57.0,1,9,17,7,France,11,-1.3212418677960753,-0.38563664199913167,1,0,1
10,8,21,18,16,100.0,1,0,18,22,Italy,11,-1.0862939699764387,0.7149485157800942,1,0,1
3,8,0,0,1,0.0,0,0,11,0,Italy,604,1.8211872325051166,-0.5087243978983329,3,3,3
5,8,0,9,14,100.0,0,0,13,0,Italy,13,0.2964690863399337,1.8759959246429279,0,3,0
33,8,563,1,1,0.0,410,9,41,973,France,11,-1.2574655382298896,-1.4372551588772537,1,0,2
5,8,3,0,1,0.0,6,2,13,9,Germany,59,-0.1358417657694628,-1.7583379286055674,2,0,2
38,14,166,7,9,77.0,16,6,52,182,Grèce,11,-1.968657062538039,-0.25143904933652855,1,0,1
4,10,0,0,1,0.0,0,0,14,0,UK,132,0.996689300577425,0.03238092484209772,3,3,0
25,8,5,0,2,100.0,2,0,33,7,US,205,-0.891269622251007,0.4453729814501786,1,0,1
5,8,7,0,2,100.0,0,0,13,7,Italy,589,-0.11647571885473577,0.4719152844986339,0,0,1
3,8,0,0,1,0.0,0,0,11,0,Belgium,471,1.8211872325051166,-0.5087243978983329,3,3,3
16,8,9,0,2,100.0,17,0,24,26,France,519,-0.8754220881690449,0.2515933896717713,1,0,1
22,8,0,0,1,0.0,0,0,30,0,Germany,664,0.8063060927681265,0.5302975016732597,3,3,0
16,21,85,2,3,25.0,4,2,37,89,Germany,324,-1.7277366697175376,-0.39287932361749955,1,0,1
13,8,3,4,1,0.0,0,0,21,3,Italy,11,-0.06236961509512932,-0.09997863727010248,2,0,2
7,9,55,1,1,0.0,13,5,16,68,France,15,-0.8411733923138498,-1.570200624431994,2,0,2
13,8,0,0,1,0.0,0,0,21,0,UK,269,0.9156841898602889,0.4272643876579216,3,3,0
8,8,18,0,1,0.0,0,4,16,18,US,14,-0.03763426015608852,-1.1870787730671524,2,0,2
7,8,1,0,1,0.0,0,0,15,1,France,310,0.4194671292710177,-0.5552771617958517,2,0,2
3,8,0,1,3,66.0,0,3,11,0,France,76,0.8511608274175049,0.21428154943870703,3,3,3
9,8,0,0,2,50.0,0,0,17,0,Germany,511,0.5784245573531004,1.2378058015684403,0,3,0
4,8,5,1,1,0.0,0,0,12,5,France,13,0.3720252063379877,-0.5659430608260326,2,0,2
3,9,103,0,1,0.0,3,1,12,106,France,13,0.03728329444539055,-2.5047628777460735,2,0,3
3,8,88,2,1,0.0,0,1,11,88,France,18,0.4343626063350891,-1.7333634808812046,2,0,3
4,20,1,0,1,0.0,0,0,24,1,US,376,0.018742925030105814,-0.6608086147398575,2,0,2
5,8,1,0,2,0.0,0,1,13,1,France,45,0.013268681955456864,-0.633976646968321,2,0,1
7,8,1,1,1,0.0,1,0,15,2,France,583,-0.13887953812625123,-0.7204724145499934,2,0,2
6,8,0,0,1,0.0,0,0,14,0,Sweden,683,1.155292251138641,0.2014957695955506,3,3,0
3,8,0,1,1,0.0,0,1,11,0,Germany,57,1.3256272739354915,-0.6954079080680463,3,3,3
4,8,0,0,1,0.0,0,0,12,0,France,272,1.3419139293825872,0.025257607180264305,3,3,0
5,10,14,0,1,0.0,0,3,15,14,US,123,-0.1494301619303266,-1.356260858005041,2,0,2
33,11,459,11,6,83.0,56,65,44,515,Spain,11,-2.019347085093019,-0.4537427269193327,1,0,1
18,9,1,5,3,100.0,0,0,27,1,France,11,-0.8714372571881087,1.2336796226518714,0,0,1
4,0,7,1,1,0.0,94,1,4,101,UK,11,0.8094619779032742,-1.7239028612649647,2,1,2
4,8,0,0,1,0.0,0,0,12,0,France,173,1.3419139293825872,0.025257607180264305,3,3,0
6,8,1,1,2,0.0,0,0,14,1,Romania,12,-0.021326938458750902,0.22481545753988194,0,0,1
4,8,7,0,2,100.0,0,0,12,7,Italy,241,-0.004163345737420665,0.3659477697529641,0,0,1
8,8,44,0,1,0.0,14,0,16,58,Italy,13,-0.15865277232132455,-1.2300306044857088,2,0,2
8,8,8,0,2,100.0,0,0,16,8,Spain,14,-0.3021385091583086,0.6346181579853714,0,0,1
11,8,5,0,1,0.0,0,0,19,5,Russia,625,0.21786560493012208,-0.5066680595766775,2,0,2
10,8,55,12,1,0.0,0,0,18,55,US,627,-0.14888401682042582,-0.29038754546801737,2,0,2
6,8,2,0,3,0.0,3,0,14,5,France,521,-0.18834168109097618,-0.5738537428809277,2,0,2
13,9,0,1,2,0.0,1,0,22,1,Italy,470,-0.4231373647458672,0.3195855603400781,1,0,1
7,8,0,37,30,90.0,0,0,15,0,UK,13,0.24506785290994626,1.779634161525278,0,3,0
29,8,2,13,26,100.0,0,0,37,2,UK,11,-0.9273304498010655,1.5385896614422843,0,0,1
8,14,3,0,1,0.0,11,0,22,14,Italy,80,-0.4427672494775687,-1.1522792442180225,2,0,2
17,8,40,3,23,95.0,0,7,25,40,France,11,-1.065510836649927,0.3555834499614295,1,0,1
5,8,0,0,4,50.0,0,0,13,0,Italy,145,0.7673532870112607,1.0855494134305523,0,3,0
111,37,237,7,35,91.0,2,1,148,239,France,11,-2.232290949310438,0.0770142062195298,1,0,1
5,8,5,2,1,0.0,5,1,13,10,Hong Kong,13,-0.3754691673656259,-1.4299743396726472,2,0,2
4,8,3,12,6,83.0,0,0,12,3,Germany,39,-0.1468767328831506,0.533584085435113,0,0,1
3,8,0,0,1,0.0,0,0,11,0,Italy,140,1.8211872325051166,-0.5087243978983329,3,3,3
3,8,0,0,1,0.0,0,0,11,0,Denmark,93,1.8211872325051166,-0.5087243978983329,3,3,3
5,9,21,11,3,0.0,0,0,14,21,Italy,11,-0.36170787673813143,0.06641182303222154,2,0,1
14,10,295,1,4,50.0,0,0,24,295,Denmark,11,-0.9724621164997662,0.4756485348016957,1,0,1
4,8,0,2,1,0.0,0,0,12,0,Spain,168,1.1006727729320178,0.3437598974846417,3,3,0
8,8,0,0,3,100.0,0,3,16,0,France,20,0.15772413649402184,1.05987193848834,0,3,0
6,8,1,4,7,100.0,0,0,14,1,France,12,-0.41069734598666263,1.0607177538403592,0,0,1
17,8,2,0,12,83.0,0,0,25,2,UK,418,-0.35397277013553874,0.6803035092627091,0,0,1
9,8,0,0,1,0.0,0,0,17,0,Spain,653,1.015136275760136,0.33363313402552847,3,3,0
7,9,14,3,1,0.0,4,1,16,18,Spain,43,-0.7483227182812173,-1.3812079912311062,2,0,2
12,22,46,0,1,0.0,12,2,34,58,Pologne,12,-0.9930635714507727,-1.680682885008879,1,0,2
7,9,8,1,6,83.0,29,0,16,37,Italy,20,-0.9857336054017211,0.01898137534595154,1,0,1
7,8,97,3,3,100.0,4,0,15,101,Belgium,40,-0.9827338708976057,0.3249219890253072,1,0,1
3,8,1,1,1,0.0,0,0,11,1,France,130,0.9171825830380885,-1.020796587464767,2,0,3
9,13,103,4,6,83.0,201,0,22,304,Spain,14,-1.4059072309971703,-0.06899435611840182,1,0,1
21,16,5979,1,6,100.0,634,40,37,6613,Hong Kong,62,-2.3071194341614256,-0.5531996540121531,1,0,1
12,12,8,2,2,0.0,0,0,24,8,UK,15,-0.6445280557404404,0.2620377274926758,1,0,1
3,8,0,0,1,0.0,0,0,11,0,UK,334,1.8211872325051166,-0.5087243978983329,3,3,3
7,8,4,31,21,100.0,0,0,15,4,France,11,-0.6118289676699141,1.182667906104789,0,0,1
8,8,2,12,16,100.0,0,0,16,2,Italy,13,-0.5989580025508502,1.2150250322007907,0,0,1
6,8,3,0,1,0.0,0,0,14,3,France,664,0.4344189663566338,-0.6652937319871997,2,0,2
8,10,87,1,1,0.0,5,2,18,92,Netherlands,120,-0.9362134297773159,-1.5120721778194106,1,0,2
8,8,0,0,1,0.0,0,0,16,0,Italy,288,1.0497295573481782,0.3009051053742669,3,3,0
8,8,0,0,1,0.0,0,0,16,0,France,686,1.0497295573481782,0.3009051053742669,3,3,0
8,8,2,0,1,0.0,0,0,16,2,UK,26,0.3450026246446371,-0.5464943808866148,2,0,2
8,8,0,0,2,0.0,0,0,16,0,France,586,0.7771150172178147,0.8362969828850325,3,3,0
4,8,0,0,1,0.0,0,0,12,0,France,470,1.3419139293825872,0.025257607180264305,3,3,0
6,11,0,2,6,100.0,0,0,17,0,France,38,-0.05411299972208609,1.8113356615978344,0,3,0
4,8,1,1,2,100.0,0,0,12,1,France,12,-0.15241204877378456,0.762569831216927,0,0,1
4,8,0,2,1,0.0,0,0,12,0,France,363,1.1006727729320178,0.3437598974846417,3,3,0
5,10,1,0,2,100.0,1,0,15,2,France,72,-0.6757856793084454,0.07831547232404311,1,0,1
6,9,241,0,1,0.0,30,4,15,271,Germany,11,-0.657376989497045,-2.0320512602477896,2,0,2
6,8,0,0,2,100.0,0,0,14,0,US,371,0.5649709224492977,1.4508801831986475,0,3,0
6,8,1,6,1,0.0,0,0,14,1,France,318,0.21303328320029546,-0.2600705766628244,2,0,2
16,10,153,0,3,100.0,2,6,26,155,Germany,13,-1.5024433210112973,-0.43986845570409605,1,0,1
5,10,2,0,1,0.0,0,0,15,2,France,30,0.21631375968445196,-0.7393630385504861,2,0,2
5,9,0,0,2,100.0,0,0,14,0,Italy,16,0.42142670483157246,1.3451094629779066,0,3,0
14,8,31,17,24,83.0,1,0,22,32,Germany,15,-1.0589259339482462,0.47463809945661134,1,0,1
3,8,1,0,1,0.0,0,0,11,1,France,655,1.1451057199666899,-1.3217155607992042,2,0,3
5,8,0,0,1,0.0,0,0,13,0,France,607,1.2296015562652718,0.13122512192593447,3,3,0
10,9,53,1,12,91.0,160,7,19,213,Sweden,11,-1.5307862975334132,-0.5297232931462693,1,0,1
20,8,203,13,22,100.0,19,5,28,222,UK,14,-1.7206629548807624,0.11451103276397562,1,0,1
7,8,10,1,9,100.0,0,0,15,10,France,89,-0.5420207804107477,0.9815912937401521,0,0,1
16,8,0,14,10,100.0,0,0,24,0,US,523,-0.06096869863552217,2.2040665401372164,0,3,0
17,8,23,2,11,63.0,45,12,25,68,Hong Kong,11,-1.40336636699506,-0.2863728833006463,1,0,1
3,8,0,0,2,0.0,0,0,11,0,France,45,1.548572692374754,0.026667479612432644,3,3,3
3,8,0,0,1,0.0,0,0,11,0,France,423,1.8211872325051166,-0.5087243978983329,3,3,3
17,15,9,1,2,100.0,0,0,32,9,Italy,15,-1.0664173328575446,1.0197007062165333,1,0,1
4,8,0,0,1,0.0,0,0,12,0,UK,548,1.3419139293825872,0.025257607180264305,3,3,0
5,8,8,0,2,0.0,1,5,13,9,Spain,13,-0.41888227800572403,-1.2395350516351298,2,0,1
7,8,23,2,6,83.0,1,0,15,24,Italy,11,-0.7561878172051538,0.1549904814033964,1,0,1
3,8,5,3,6,100.0,0,0,11,5,France,11,0.201312907422564,0.25252096287596987,0,0,3
3,8,257,0,1,0.0,0,0,11,257,France,12,0.8814187363721285,-1.63869768627519,2,0,3
6,8,0,0,1,0.0,0,0,14,0,France,610,1.155292251138641,0.2014957695955506,3,3,0
3,8,0,0,1,0.0,0,0,11,0,France,513,1.8211872325051166,-0.5087243978983329,3,3,3
5,8,0,0,2,0.0,0,0,13,0,UK,11,0.9569870161349087,0.6666169994366998,3,3,0
7,9,6,6,8,100.0,0,0,16,6,UK,131,-0.7545872772842257,0.9962400715648668,0,0,1
10,8,3,26,10,0.0,155,30,18,158,France,11,-1.1883212859281602,-0.7501942223314765,1,0,1
13,8,2,0,4,100.0,0,0,21,2,Belgium,34,-0.4049006223795713,0.8794009389618437,0,0,1
10,10,156,1,2,100.0,1,1,20,157,Spain,15,-1.5766391579311603,-0.1924793186329248,1,0,1
13,8,3,16,28,96.0,0,0,21,3,Romania,11,-0.6356107786361146,1.0574121909968184,0,0,1
13,10,46,7,12,100.0,0,0,23,46,UK,11,-1.086151508145677,1.0544227181967285,0,0,1
25,1,0,32,28,89.0,0,0,26,0,Spain,12,0.30005584965889615,2.1788957461295158,0,3,0
21,8,61,5,9,66.0,170,1,29,231,Italy,56,-1.5030615104679599,-0.2585170291959305,1,0,1
4,10,9,0,1,0.0,17,3,14,26,France,235,-0.44437221004894045,-1.9569284878749154,2,0,2
8,8,0,9,1,0.0,9,2,16,9,US,39,-0.24489398940075194,-0.8195693644671598,2,0,2
5,8,8,0,1,0.0,1,0,13,9,France,69,0.14977658947636907,-1.235569346138744,2,0,2
5,8,1,2,4,80.0,0,0,13,1,France,23,-0.1587894090879979,0.6108820673221204,0,0,1
4,8,0,0,1,0.0,0,0,12,0,Italy,591,1.3419139293825872,0.025257607180264305,3,3,0
4,8,0,0,1,0.0,0,0,12,0,UK,210,1.3419139293825872,0.025257607180264305,3,3,0
10,8,0,2,1,0.0,0,0,18,0,Spain,626,0.7455129243941827,0.678793879580369,3,3,0
6,10,45,2,1,0.0,1,3,16,46,France,45,-0.8209591869809378,-1.503654238742314,2,0,2
5,8,0,0,1,0.0,0,0,13,0,France,638,1.2296015562652718,0.13122512192593447,3,3,0
9,10,27,2,2,100.0,6,1,19,33,France,13,-1.502448593568964,-0.1287966714028516,1,0,1
123,8,1,117,86,100.0,0,0,131,1,US,55,-1.2439199529143106,1.9650752512104515,0,0,1
73,27,104,8,69,98.0,182,115,100,286,France,11,-2.3314620246171973,-0.18294696163568563,1,0,1
6,8,32,0,4,75.0,23,0,14,55,Austria,174,-0.5202882667551605,-0.35989481905275655,2,0,1
20,22,4,0,6,66.0,235,25,42,239,France,219,-1.6403694330446688,-0.7670663574696333,1,0,1
7,11,4,0,1,0.0,15,1,18,19,UK,590,-0.618218170531064,-1.7160884938638261,2,0,2
3,9,24,0,1,0.0,4,1,12,28,France,83,0.10533503221247927,-2.4241600770136804,2,0,3
3,8,1,1,1,0.0,0,0,11,1,UK,11,0.9171825830380885,-1.020796587464767,2,0,3
11,8,0,4,1,0.0,0,0,19,0,US,560,0.7026506708727096,0.7249980584187823,3,3,0
6,13,36,0,2,0.0,2,0,19,38,US,346,-0.6893344736296195,-0.7430148075363807,1,0,2
20,8,0,4,2,100.0,0,0,28,0,Belgium,181,-0.021332605666113127,2.1001467998528236,0,3,0
8,8,1,0,2,100.0,0,0,16,1,Germany,81,-0.2166732838795923,0.7372983560764929,0,0,1
3,8,0,0,2,100.0,0,0,11,0,France,585,1.2308659038157737,0.7406600157047639,3,3,3
4,8,4,0,1,0.0,0,0,12,4,France,107,0.6087700080331391,-0.8562572957047054,2,0,2
12,8,2,1,1,0.0,0,0,20,2,Germany,17,0.0036730647001268404,-0.13881466979723422,2,0,2
3,8,0,1,3,0.0,0,0,11,0,France,96,1.305008201308965,0.3583047482891319,3,3,3
6,8,1,2,3,66.0,0,3,14,1,UK,40,-0.5041336860093674,0.12909387100166006,0,0,1
16,8,0,2,3,100.0,0,0,24,0,UK,21,0.02271417384193763,2.068987512204137,0,3,0
7,8,0,3,3,100.0,0,0,15,0,US,423,0.2397348142076846,1.8676864678352072,0,3,0
9,8,0,3,2,100.0,0,0,17,0,US,47,0.17496380229556274,1.9128873054134534,0,3,0
31,28,57,2,6,50.0,0,0,59,57,France,226,-1.2627628158276325,0.7799672076829401,1,0,1
11,9,18,11,6,85.0,18,0,20,36,France,11,-1.1689241514873452,0.199126575223336,1,0,1
36,41,89,35,23,86.0,128,1,77,217,Hong Kong,11,-2.163507839905322,-0.10733678510628773,1,0,1
5,8,0,1,2,0.0,0,0,13,0,France,152,0.7290638792063076,0.9675359727711368,3,3,0
9,8,2,3,1,0.0,0,0,17,2,US,73,0.06055819828136494,-0.18389659445052495,2,0,2
11,8,0,0,4,0.0,0,0,19,0,France,96,0.6616801000687814,0.9709950832365284,3,3,0
5,0,0,0,1,0.0,0,0,5,0,UK,621,2.4387352182846023,0.07649590508851316,3,1,2
5,8,1,3,4,100.0,4,1,13,5,US,22,-0.9493733970568994,-0.058242710162933774,1,0,1
21,8,0,23,13,84.0,0,0,29,0,US,11,0.004834602424269278,1.9707855405341712,0,3,0
7,8,112,0,1,0.0,61,2,15,173,Germany,25,-0.46912969295370316,-1.8793525109837605,2,0,2
18,9,180,5,2,100.0,58,18,27,238,Netherlands,13,-1.811996529610026,-0.22777400594873215,1,0,1
4,8,0,1,1,0.0,0,0,12,0,Belgium,382,1.1139907924539865,0.32617658051470094,3,3,0
3,8,0,1,2,100.0,0,0,11,0,France,183,1.0029427668871727,1.0415789890392004,0,3,3
5,8,8,9,1,0.0,0,0,13,8,Germany,11,0.1917157895592618,-0.4196054511318248,2,0,2
3,8,1,0,3,100.0,2,5,11,3,Germany,260,-0.1053760171073764,-1.0712463596217443,2,0,3
3,8,0,0,1,0.0,0,0,11,0,UK,147,1.8211872325051166,-0.5087243978983329,3,3,3
7,8,0,0,3,66.0,0,0,15,0,Monaco,125,0.6394881116780596,1.2009368509389093,0,3,0
7,16,82,0,1,0.0,44,16,23,126,France,18,-0.9271407515034362,-1.9365506847500535,2,0,2
39,17,474,66,41,87.0,17,0,56,491,Chypre,11,-1.8687417770594696,0.40128913903888835,1,0,1
3,8,0,0,1,0.0,0,0,11,0,Swiss,687,1.8211872325051166,-0.5087243978983329,3,3,3
5,8,2,0,1,0.0,0,0,13,2,Netherlands,356,0.5248746235617312,-0.7161743643349475,2,0,2
3,8,0,4,5,80.0,0,0,11,0,France,17,1.085594100861579,0.8193915098537661,3,3,3
6,9,14,1,1,0.0,34,12,15,48,France,259,-0.7841340100426956,-1.6235554852939011,2,0,2
4,8,0,6,4,100.0,1,8,12,1,France,16,-0.5061641354312585,0.24654513225677982,1,0,1
9,8,0,1,4,100.0,0,0,17,0,Italy,29,0.17135525929521567,1.9340881449247689,0,3,0
7,8,2,8,9,66.0,0,0,15,2,France,39,-0.37316762013832433,0.7822753273597014,0,0,1
13,8,0,1,7,85.0,0,0,21,0,Italy,109,0.19703137658330766,1.7417336768117662,0,3,0
5,8,1,0,1,0.0,0,0,13,1,France,568,0.5535200437268449,-0.6817660409749369,2,0,2
4,8,11,9,1,0.0,4,2,12,15,UK,40,-0.33157808586983184,-1.5358006127562212,2,0,2
7,8,4,0,15,53.0,0,0,15,4,Italy,78,-0.1442865211848122,0.4181255145609255,0,0,1
12,8,15,8,4,75.0,6,0,20,21,France,11,-0.9459883649922844,0.29307145537900936,1,0,1
11,11,385,3,8,100.0,39,3,22,424,Italy,13,-1.8362784304553386,-0.23937283895615727,1,0,1
9,9,0,0,4,25.0,0,0,18,0,Spain,26,0.3686284578663654,1.2219307814647646,0,3,0
10,8,4,5,3,100.0,1,0,18,5,Italy,70,-0.9354091724668995,0.650789964819487,1,0,1
6,8,2,0,2,100.0,0,0,14,2,France,377,-0.13975601025424325,0.603480696937766,0,0,1
7,8,0,0,1,0.0,0,0,15,0,UK,158,1.0955486418094451,0.2577140011050194,3,3,0
32,8,1,4,19,100.0,0,0,40,1,Italy,11,-0.890995499665073,1.5460283712886405,0,0,1
5,8,22,1,1,0.0,0,0,13,22,France,47,0.1951473905862919,-0.5376264686777329,2,0,2
6,8,13,0,1,0.0,3,1,14,16,France,13,-0.2311569461341143,-1.703372582993738,2,0,2
13,8,0,0,4,75.0,0,0,21,0,UK,98,0.4467168273806095,1.3966887103396979,0,3,0
6,8,30,2,1,0.0,6,0,14,36,Italy,21,-0.2555137761003001,-0.9606601535690591,2,0,2
6,8,221,42,5,100.0,1,0,14,222,Italy,13,-1.0294149891621913,0.3577019523458182,1,0,1
4,8,40,0,2,100.0,9,4,12,49,France,165,-0.7319156357598006,-0.7655336174776218,1,0,1
5,9,5,5,3,0.0,1,0,14,6,Italy,17,-0.600690601964485,-0.3373376501597847,1,0,2
3,8,3,2,1,0.0,4,2,11,7,UK,19,0.2254745492683673,-2.065152575495614,2,0,3
4,8,4,1,1,0.0,11,0,12,15,UK,20,-0.0009258852639365897,-1.091781589926616,2,0,2
11,9,14,3,24,87.0,0,0,20,14,Italy,14,-0.7886602817609267,0.801920746890623,0,0,1
8,8,36,0,4,50.0,2,0,16,38,France,101,-0.5727185824785687,-0.21044549235925172,1,0,1
18,19,17,0,2,0.0,1,0,37,18,Spain,16,-0.9261418865981202,-0.4582059150874747,1,0,2
13,9,0,10,3,66.0,186,15,22,186,Spain,14,-1.1837697782306051,-0.05698800269161063,1,0,1
30,8,2,4,1,0.0,0,0,38,2,France,382,-0.23652744976331697,0.09775371245392117,2,0,2
4,8,2,0,1,0.0,0,0,12,2,US,466,0.6371869966790462,-0.8221418790806176,2,0,2
3,8,2,0,1,0.0,0,0,11,2,UK,18,1.1164602998015765,-1.3561238841592147,2,0,3
39,77,29,2,13,76.0,0,0,116,29,Italy,36,-1.400893813367474,0.9363867781502344,1,0,1
8,9,4,3,5,60.0,0,3,17,4,UK,24,-0.8807464718022309,0.1424285796855751,1,0,1
3,8,44,0,2,0.0,2,0,11,46,France,14,0.3788750041216247,-1.4503853693462443,2,0,3
6,8,0,1,1,0.0,0,0,14,0,France,46,0.9273691142100399,0.5024147429299874,3,3,0
8,8,0,0,1,0.0,1,1,16,1,Spain,646,0.1207051109966536,-1.061325310364766,2,0,2
7,19,0,0,1,0.0,16,0,26,16,France,181,-0.1545332914148238,-0.7536046445208763,2,0,2
47,56,1,23,21,85.0,0,0,103,1,Romania,11,-1.3254357609280787,1.240975474853857,1,0,1
4,9,17,0,1,0.0,7,4,13,24,France,24,-0.34344169310398376,-1.975146447955558,2,0,2
4,11,0,0,3,0.0,7,0,15,7,Spain,174,-0.09088256867885104,-0.3437217904449447,2,0,1
6,9,87,3,1,0.0,5,3,15,92,Germany,15,-0.8094034474086877,-1.5741607786260512,2,0,2
22,9,0,4,8,87.0,0,0,31,0,Netherlands,15,-0.12056312923576042,1.821383634992524,0,3,0
3,8,0,0,1,0.0,0,0,11,0,UK,177,1.8211872325051166,-0.5087243978983329,3,3,3
5,13,2,0,1,0.0,103,6,18,105,Germany,17,-0.6987613002103068,-1.91336808619304,2,0,2
7,8,3,0,1,0.0,0,0,15,3,Romania,425,0.37467535702743776,-0.6090755004777307,2,0,2
6,10,0,0,1,0.0,0,1,16,0,UK,688,0.5986680031058376,-0.3254778472698307,3,3,0
3,8,0,0,1,0.0,2,1,11,2,France,319,0.86791632421832,-1.9027634169657215,2,0,3
7,8,0,0,1,0.0,0,0,15,0,UK,397,1.0955486418094451,0.2577140011050194,3,3,0
7,9,1,0,1,0.0,0,0,16,1,Germany,472,0.2211870440121614,-0.606959693492669,2,0,2
5,8,3,0,2,0.0,1,0,13,4,Denmark,57,-0.08607447403070367,-0.6561217489201042,2,0,2
41,9,16,8,6,100.0,3,0,50,19,Germany,15,-1.5330588502127716,0.8438750320055677,1,0,1
8,18,122,3,1,0.0,33,0,26,155,Grèce,11,-0.9272051224163971,-1.012141450055689,1,0,2
5,11,9,1,2,100.0,10,0,16,19,France,17,-1.091630211994978,0.23098250817843927,1,0,1
3,8,0,2,3,66.0,0,0,11,0,Denmark,42,1.1238855459231616,0.7530007422399341,3,3,3
26,8,11,1,5,60.0,0,0,34,11,Italy,14,-0.7081238948675361,0.9130755809293049,0,0,1
6,9,31,0,1,0.0,0,1,15,31,Italy,16,-0.1433853893857781,-1.318640067060475,2,0,2
3,8,0,0,1,0.0,0,0,11,0,France,272,1.8211872325051166,-0.5087243978983329,3,3,3
5,10,0,0,1,0.0,0,0,15,0,Italy,292,0.921040692387993,0.10803644771039539,3,3,0
6,8,13,0,7,57.0,2,1,14,15,Spain,13,-0.7037741356780834,-0.7021677130465238,1,0,1
29,8,29,0,2,0.0,0,0,37,29,France,17,-0.35444395442171106,0.1463686216623439,2,0,1
4,8,0,0,1,0.0,0,0,12,0,US,586,1.3419139293825872,0.025257607180264305,3,3,0
31,8,6,0,1,0.0,0,0,39,6,France,318,-0.033125440168485426,-0.286315635030512,2,0,2
9,8,1,1,12,91.0,5,0,17,6,UK,358,-0.7786110560291651,0.3530824052982647,1,0,1
40,8,0,1,14,78.0,0,0,48,0,France,282,-0.06762362162866326,2.0113888926576005,0,3,0
5,8,4,0,1,0.0,0,0,13,4,US,397,0.4964576349158239,-0.7502897809590354,2,0,2
7,9,1,2,1,0.0,0,0,16,1,Swiss,644,-0.02005411243840836,-0.28845740318829144,2,0,2
10,9,3,0,1,0.0,1,1,19,4,US,47,-0.509420657591002,-1.5123176773567824,2,0,2
10,10,9,0,4,75.0,4,0,20,13,Canada,103,-0.8435406459588464,-0.15090270818373328,1,0,1
3,8,0,1,1,0.0,0,0,11,0,France,172,1.5932640955765163,-0.20780542456389617,3,3,3
7,8,0,6,2,100.0,0,0,15,0,Sweden,33,0.23904985772018375,1.8585232313506124,0,3,0
3,8,1,2,2,0.0,0,0,11,1,Italy,338,0.6312500233857564,-0.46782139298406106,2,0,3
6,8,5,0,1,0.0,30,4,14,35,France,125,-0.296160349917599,-1.8062615096341417,2,0,2
34,8,3,3,11,90.0,3,0,42,6,Sweden,14,-1.1280282565121222,0.6557489279185628,1,0,1
14,13,94,3,3,66.0,44,10,27,138,US,11,-1.7034943404410003,-0.5469152751435603,1,0,1
6,8,3,4,2,100.0,0,0,14,3,Italy,12,-0.41308288250612035,0.9236371582706233,0,0,1
13,10,1,3,13,76.0,0,5,23,1,France,11,-1.0504965210178239,0.3684257668367111,1,0,1
33,8,3,3,3,0.0,0,0,41,3,UK,121,-0.5555346072268103,0.6559983866643297,0,0,1
10,9,23,2,3,66.0,3,0,19,26,US,65,-1.0400062171829292,0.11225792218347565,1,0,1
30,0,6,1,2,100.0,9,10,30,15,Netherlands,17,-0.7340622608756401,0.4659754861717256,0,2,2
7,8,157,3,1,0.0,1,6,15,158,UK,11,-0.6818936959401437,-1.50314319881396,2,0,2
5,8,1,11,6,100.0,0,0,13,1,France,11,-0.35576002028709725,1.0130174281400428,0,0,1
4,8,20,0,2,100.0,6,7,12,26,Germany,131,-0.7019323035361485,-0.7346198804638642,1,0,1
31,9,0,0,1,0.0,0,0,40,0,UK,367,0.544304623407453,0.5411755587397323,3,3,0
7,8,0,0,1,0.0,0,0,15,0,UK,708,1.0955486418094451,0.2577140011050194,3,3,0
4,8,4,0,1,0.0,0,0,12,4,Italy,33,0.6087700080331391,-0.8562572957047054,2,0,2
27,9,55,2,5,100.0,0,0,36,55,Serbie,16,-1.133084473634702,1.111767189485442,0,0,1
5,8,0,0,1,0.0,0,0,13,0,France,246,1.2296015562652718,0.13122512192593447,3,3,0
5,8,0,0,1,0.0,0,0,13,0,Germany,600,1.2296015562652718,0.13122512192593447,3,3,0
14,8,22,6,13,61.0,2,2,22,24,Netherlands,25,-1.2834988838225585,-0.11606519872201435,1,0,1
3,8,0,0,2,0.0,0,0,11,0,Italy,666,1.548572692374754,0.026667479612432644,3,3,3
34,16,35,28,24,84.0,1,0,50,36,Italy,11,-1.6014104163167104,0.5584754240640254,1,0,1
6,9,12,1,1,0.0,1,0,15,13,France,80,-0.3766736698056956,-0.9267532315570586,2,0,2
9,8,1,19,12,91.0,0,0,17,1,Spain,14,-0.46690267475931146,0.9660183381813194,0,0,1
15,8,0,21,11,100.0,0,0,23,0,France,11,-0.059161554579360474,2.2095875515261363,0,3,0
167,8,2,19,170,99.0,0,0,175,2,Monaco,12,-1.215733589758185,1.7445244247792244,0,0,1
4,8,0,0,1,0.0,0,0,12,0,France,12,1.3419139293825872,0.025257607180264305,3,3,0
6,8,6,1,2,100.0,5,1,14,11,UK,375,-1.0330572240405718,-0.13540404060466774,1,0,1
10,8,0,17,4,100.0,0,0,18,0,US,23,0.0811693813082006,2.0423438487425343,0,3,0
20,8,1,2,9,77.0,0,0,28,1,Italy,180,-0.5858702198795519,1.0370523519393384,0,0,1
5,9,12,0,2,0.0,1,0,14,13,France,20,-0.35653676507586146,-0.7547125026367637,2,0,2
6,8,0,0,1,0.0,0,0,14,0,Italy,602,1.155292251138641,0.2014957695955506,3,3,0
12,8,0,0,10,100.0,0,0,20,0,France,71,0.2921480057657413,1.7628145604761472,0,3,0
30,8,79,0,1,0.0,3,0,38,82,Japon,11,-0.47979150841648643,-0.9153350545309488,2,0,2
5,8,0,0,1,0.0,0,0,13,0,France,138,1.2296015562652718,0.13122512192593447,3,3,0
4,8,3,0,1,0.0,0,0,12,3,France,481,0.6210406446005802,-0.8415318944024858,2,0,2
5,8,138,1,2,100.0,54,6,13,192,Belgium,14,-1.1829041877109343,-0.5035137192736742,1,0,1
4,8,0,0,1,0.0,0,0,12,0,UK,509,1.3419139293825872,0.025257607180264305,3,3,0
4,7,0,0,1,0.0,0,0,11,0,France,71,1.7404327368262589,0.0436624249370234,3,3,2
23,8,4,2,2,100.0,0,0,31,4,Netherlands,11,-0.7697565639513723,1.227238042226304,0,0,1
12,8,11,0,13,92.0,2,2,20,13,Italy,13,-0.9632817063225715,-0.4327380955754481,1,0,1
30,8,0,6,7,83.3,0,0,38,0,France,13,-0.03064062765358257,1.9685895927683028,0,3,0
5,9,77,2,3,66.0,3,6,14,80,Hong Kong,11,-1.1891551424525506,-0.7080096892164127,1,0,1
5,8,0,0,2,100.0,0,0,13,0,France,75,0.6392802275759288,1.3806095355290313,0,3,0
19,14,175,0,4,0.0,107,5,33,282,Denmark,201,-1.4063207429073035,-1.2241561345854213,1,0,1
9,8,0,0,1,0.0,0,0,17,0,Romania,83,1.015136275760136,0.33363313402552847,3,3,0
9,8,2,10,12,84.0,0,0,17,2,Belgium,11,-0.4769332164773602,0.9027546507349525,0,0,1
19,13,56,0,3,100.0,3,11,32,59,Germany,12,-1.5787973052940723,-0.3809389074680823,1,0,1
9,9,4,0,1,0.0,0,1,18,4,Luxembourg,309,-0.17184164454058398,-1.0971564021019191,2,0,2
16,8,1,4,15,100.0,757,31,24,758,Germany,42,-1.6581336846093948,-0.04832987695222439,1,0,1
3,8,0,0,1,0.0,0,0,11,0,Austria,118,1.8211872325051166,-0.5087243978983329,3,3,3
25,10,7,0,1,0.0,0,1,35,7,Italy,12,-0.47603133089392735,-0.926863842744598,2,0,2
5,8,0,6,4,100.0,0,0,13,0,Spain,13,0.34756622132903486,1.7821859761332344,0,3,0
4,8,1,0,1,0.0,0,0,12,1,France,174,0.6658324168441598,-0.7877335557206069,2,0,2
4,8,6,2,2,100.0,1,0,12,7,Italy,15,-0.5586753313118988,0.23930505207046632,0,0,1
5,8,0,0,1,0.0,6,1,13,6,France,603,0.2378907006001576,-1.3133443266200038,2,0,2
13,8,0,15,10,100.0,3,0,21,3,France,14,-0.71535928699153,1.237334405806555,0,0,1
6,9,0,0,1,0.0,0,4,15,0,Germany,508,0.6554720875732133,-0.3728257366699066,3,3,0
26,9,27,2,2,100.0,6,3,35,33,Sweden,28,-1.6898358547055103,0.06877588627382643,1,0,1
6,9,2,4,17,76.0,0,0,15,2,Italy,18,-0.5311090869954631,0.7125948509716465,0,0,1
65,157,792,2,3,0.0,707,18,222,1499,Ukraine,11,-2.29192751422683,-0.9046639200535914,1,0,1
28,8,0,0,1,0.0,0,0,36,0,France,620,0.7468681622483131,0.585805929959809,3,3,0
30,9,21,1,1,0.0,0,0,39,21,UK,76,-0.4778474694245008,-0.13415226243767273,2,0,2
4,8,0,0,2,50.0,0,0,12,0,France,315,0.9052022109755519,0.9294302747231762,3,3,0
8,8,24,1,7,100.0,0,0,16,24,France,28,-0.6214440817304886,0.9599035592841307,0,0,1
8,8,3,0,2,100.0,0,1,16,3,UK,33,-0.5291018777641968,0.1958975338904641,0,0,1
13,9,52,0,7,85.0,1,4,22,53,France,46,-1.2095318648731286,-0.6300965138188451,1,0,1
3,8,0,0,1,0.0,0,0,11,0,UK,395,1.8211872325051166,-0.5087243978983329,3,3,3
5,8,2,0,1,0.0,0,0,13,2,Italy,660,0.5248746235617312,-0.7161743643349475,2,0,2
6,8,5,0,1,0.0,0,0,14,5,US,690,0.41332666502264265,-0.6906238717451832,2,0,2
30,8,0,4,3,100.0,0,0,38,0,Italy,80,-0.1377631998863066,2.225255907660163,0,3,0
6,8,0,1,1,0.0,0,0,14,0,UK,18,0.9273691142100399,0.5024147429299874,3,3,0
3,8,1,0,1,0.0,0,0,11,1,Italy,628,1.1451057199666899,-1.3217155607992042,2,0,3
6,8,0,1,1,0.0,0,1,14,0,Austria,116,0.6597322925690152,0.014812259425837339,3,3,0
57,11,26,55,31,100.0,3,0,68,29,Bulgaria,11,-1.806953923554148,1.0245249455162402,1,0,1
6,8,0,9,8,100.0,0,1,14,0,US,24,-0.025023023643296522,1.418494131462709,0,3,0
4,8,2,1,3,100.0,0,0,12,2,France,19,-0.19669882307608574,0.7588798031991789,0,0,1
6,8,0,3,1,0.0,0,0,14,0,Spain,11,0.9054411063634108,0.531365527380379,3,3,0
5,8,1,0,1,0.0,0,0,13,1,Italy,13,0.5535200437268449,-0.6817660409749369,2,0,2
30,8,7,6,48,35.0,0,0,38,7,Bulgaria,43,-0.8344588260388406,1.1508449977817659,0,0,1
11,10,0,1,2,100.0,1,0,21,1,Portugal,22,-0.7646258550238997,0.9852443104126158,0,0,1
33,9,6,0,5,80.0,0,0,42,6,France,15,-0.6945466729685921,0.6395369542909913,0,0,1
3,8,5,1,1,0.0,1,0,11,6,France,11,0.5312980837105911,-1.553173905045545,2,0,3
7,10,11,2,1,0.0,0,0,17,11,US,15,-0.18985782159710368,-0.4083488163089857,2,0,2
21,9,0,1,4,50.0,0,1,30,0,France,119,-0.3141443560009715,1.2155069831995275,0,3,0
3,8,7,0,1,0.0,1,0,11,8,Swiss,13,0.7458761085301501,-1.8701179118533764,2,0,3
4,8,0,0,2,0.0,0,0,12,0,UK,127,1.0692993892522238,0.5606494846910302,3,3,0
28,9,15,1,2,100.0,0,1,37,15,UK,126,-1.2999800761660893,0.628910731098022,1,0,1
7,8,5,4,4,100.0,0,0,15,5,France,17,-0.5194553440162831,1.0046768739838152,0,0,1
31,0,17,0,1,0.0,0,0,31,17,France,125,0.7060126833752751,-0.04302987870151485,2,2,2
7,8,6,0,4,100.0,2,1,15,8,UK,266,-0.8703509439333786,-0.302585344016024,1,0,1
3,9,0,0,1,0.0,0,0,12,0,Italy,323,1.5244381286479025,-0.4789970662655853,3,3,3
9,10,62,8,9,100.0,10,1,19,72,France,15,-1.6349490561143565,-0.04995021121022769,1,0,1
11,8,0,6,13,92.0,1,0,19,1,Sweden,71,-0.4844624134694131,0.9281281230541296,0,0,1
5,9,13,0,1,0.0,24,5,14,37,France,43,-0.4613289942664203,-1.9394352907418884,2,0,2
17,10,81,20,20,100.0,80,9,27,161,Austria,11,-1.9186901160517131,0.0022412498834189403,1,0,1
8,9,29,25,20,92.8,0,1,17,29,Netherlands,14,-1.0583955966617244,0.2611515776137247,1,0,1
4,8,0,0,1,0.0,0,0,12,0,France,694,1.3419139293825872,0.025257607180264305,3,3,0
3,8,0,1,1,0.0,0,0,11,0,France,244,1.5932640955765163,-0.20780542456389617,3,3,3
11,8,9,0,2,0.0,6,1,19,15,Spain,26,-0.7009351559334285,-0.9885803162035716,1,0,1
31,10,521,3,2,0.0,159,17,41,680,Portugal,11,-1.7375235993539386,-0.9525532935428902,1,0,1
3,8,2,0,2,0.0,4,0,11,6,UK,84,0.4847212695587834,-1.3261466007342644,2,0,3
21,9,3,20,27,85.0,0,0,30,3,Italy,11,-0.9058468739445634,1.0686655325732601,0,0,1
3,8,0,1,1,0.0,0,0,11,0,France,133,1.5932640955765163,-0.20780542456389617,3,3,3
31,7,14,3,1,0.0,9,1,38,23,Grèce,17,-0.675679093791968,-0.8767738836919426,2,0,2
54,8,5,102,63,98.0,3,0,62,8,US,293,-1.3803729231232065,0.9486421954926564,1,0,1
5,8,0,0,1,0.0,0,0,13,0,UK,706,1.2296015562652718,0.13122512192593447,3,3,0
3,8,3,0,1,0.0,8,2,11,11,France,191,0.4470785060869229,-2.4098353399179353,2,0,3
11,9,1,0,1,0.0,0,0,20,1,Italy,684,0.10137822552634422,-0.49237467186090134,2,0,2
107,3649,310,217,70,98.0,0,0,3756,310,France,11,-2.797790833229903,1.4324089816372108,1,0,1
