socialNbFollowers,socialNbFollows,socialProductsLiked,productsListed,productsSold,productsPassRate,productsWished,productsBought,social,products,country,daysSinceLastLogin,x,y,kmeans,spectral,aggl
31,8,0,1,1,0.0,0,1,39,0,France,127,0.22065355544473955,0.4279771267226958,1,3,0
7,8,6,1,1,0.0,0,0,15,6,France,485,0.11828655069799364,-0.3423432974834527,3,0,2
10,8,0,0,3,66.0,0,0,18,0,UK,665,0.5306935507133681,1.303514439109882,2,3,0
3,8,0,0,1,0.0,0,0,11,0,France,405,1.8211872325051175,-0.5087243978983353,1,3,3
16,0,6,0,1,0.0,303,32,16,309,UK,20,0.12392511510043387,-1.514337724207306,3,2,2
8,8,0,4,3,100.0,0,0,16,0,Finland,82,0.1865863543482376,1.9205542909743527,2,3,0
5,8,6,0,1,0.0,223,3,13,229,Hong Kong,16,-0.30931300373445214,-1.9877613394887388,3,0,2
29,8,33,2,2,100.0,17,8,37,50,Netherlands,377,-1.6010977364637873,0.08429624163822161,0,0,1
5,8,1,0,2,0.0,0,0,13,1,Germany,192,0.2809055035964815,-0.14637416346417104,3,0,2
16,9,373,0,5,0.0,47,7,25,420,UK,362,-1.254025425656657,-1.2476848314395528,0,0,1
26,9,1,3,1,0.0,1,0,35,2,Italy,15,-0.6642096762950999,-0.4527867883851317,3,0,2
11,8,23,0,3,100.0,0,0,19,23,Sweden,87,-0.45452496768596856,0.6935319864866227,2,0,1
6,8,0,5,1,0.0,0,0,14,0,Netherlands,16,0.8930755217867168,0.5476913776895777,1,3,0
5,15,3,0,1,0.0,8,1,20,11,France,166,-0.6270988905207147,-1.7132894472980231,3,0,2
3,8,1,0,1,0.0,0,0,11,1,France,591,1.145105719966689,-1.3217155607992064,3,0,3
3,9,7,4,3,66.0,1,0,12,8,Italy,23,-0.26411404563186225,-0.557621253732015,3,0,3
3,8,0,0,1,0.0,0,0,11,0,France,27,1.8211872325051175,-0.5087243978983353,1,3,3
6,8,0,0,1,0.0,0,0,14,0,US,681,1.1552922511386414,0.2014957695955512,1,3,0
7,8,3,2,2,100.0,0,0,15,3,US,27,-0.456887128112475,0.9588112034297434,2,0,1
15,8,7,10,4,50.0,0,0,23,7,France,12,-0.6120988316265753,0.8702091113339395,2,0,1
42,16,31,9,11,90.0,3,5,58,34,US,21,-1.9016000381554776,-0.035467275727856365,0,0,1
30,8,0,0,1,0.0,0,0,38,0,US,578,0.725380003113636,0.6056067220600779,1,3,0
20,8,8,1,1,0.0,0,0,28,8,US,111,-0.16330063154910365,-0.10353647806255391,3,0,2
5,8,20,1,1,0.0,0,0,13,20,US,93,0.20042418128922837,-0.5312821851740499,3,0,2
3,8,1,0,1,0.0,0,0,11,1,France,707,1.145105719966689,-1.3217155607992064,3,0,3
5,8,3,1,1,0.0,0,0,13,3,France,153,0.28080513455466355,-0.43464540632237825,3,0,2
28,11,12,0,1,0.0,3,57,39,15,Italy,11,-0.9744077878992337,-1.5483685874022213,0,0,2
11,8,48,4,7,100.0,1,2,19,49,France,11,-1.3722041857289329,0.08241180155703455,0,0,1
10,14,42,0,1,0.0,5,1,24,47,Germany,85,-0.826986135955866,-1.687908837981955,3,0,2
12,8,13,12,16,100.0,4,0,20,17,Australia,24,-1.132575472028955,0.7434628921128034,0,0,1
20,9,0,0,2,0.0,0,0,29,0,Germany,298,0.3807742342599056,0.9738432915597883,1,3,0
3,9,38,4,1,0.0,33,3,12,71,France,16,-0.24198155428887458,-2.2127387482037695,3,0,3
10,48,191,0,1,0.0,11,6,58,202,Netherlands,12,-1.2260557870141726,-1.7644366841730637,0,0,2
6,12,0,0,1,0.0,1,1,18,1,Italy,488,-0.151870237292569,-1.1844892565245821,3,0,2
16,10,25,1,5,100.0,2,0,26,27,UK,11,-1.3525422677750587,0.5554323472824069,0,0,1
5,8,2,25,4,75.0,0,0,13,2,France,11,-0.24593565520998759,0.6517626398712423,2,0,1
3,10,30,0,1,0.0,8,0,13,38,France,34,0.22073984984571,-1.9262307545123927,3,0,3
25,30,410,3,2,100.0,45,2,55,455,Spain,11,-2.134811101279982,-0.15443628350085462,0,0,1
15,8,0,18,14,100.0,0,0,23,0,UK,29,-0.06315590801188894,2.220705901761162,2,3,0
9,8,0,6,8,0.0,0,0,17,0,UK,665,0.4303261846671518,1.3108254720127686,2,3,0
3,8,1,0,1,0.0,0,0,11,1,France,691,1.145105719966689,-1.3217155607992064,3,0,3
6,8,0,1,4,50.0,0,0,14,0,France,62,0.4651208449560293,1.4567390344346052,2,3,0
137,13,60,33,163,94.0,10,3,150,70,France,11,-2.2426769459632627,0.35907224347978417,0,0,1
4,8,9,0,1,0.0,0,2,12,9,UK,642,0.2969745817849355,-1.4039870500460156,3,0,2
4,8,0,1,2,0.0,1,0,12,1,Spain,600,0.17998862761312223,-0.013059474209415802,3,0,1
6,8,2,0,1,0.0,0,0,14,2,Sweden,188,0.4505653184351001,-0.6459037166653306,3,0,2
24,8,0,0,5,100.0,0,0,32,0,France,12,0.15980974003937765,1.865934588027666,2,3,0
5,11,0,2,1,0.0,0,0,16,0,France,540,0.6204447484788527,0.4405611553554114,1,3,0
4,9,0,3,2,100.0,3,1,13,3,France,31,-0.7103657914705555,0.17931466996959328,0,0,1
25,8,0,0,2,0.0,0,0,33,0,Spain,695,0.5019139310122261,1.095306290173641,2,3,0
4,8,8,0,1,0.0,1,0,12,9,Chypre,29,0.2620889625936839,-1.3415368608844145,3,0,2
7,8,1,2,12,83.0,0,1,15,1,France,14,-0.5971913498672101,0.32223446646912063,2,0,1
4,9,123,1,1,0.0,0,1,13,123,France,28,-0.29552558644825216,-1.2527168590455564,3,0,2
21,8,17,0,2,100.0,1,0,29,18,UK,455,-0.8861504187352399,0.3655381502918851,0,0,1
71,9,22,0,18,66.0,14,11,80,36,Netherlands,14,-1.6089752866469182,-0.3193398657820835,0,0,1
6,10,36,5,1,0.0,1,1,16,37,Italy,11,-0.8124602531840659,-1.4291429154853994,3,0,2
25,8,1,0,4,75.0,0,0,33,1,Italy,12,-0.3705204038755173,0.71634757244378,2,0,1
6,8,0,0,1,0.0,0,0,14,0,France,612,1.1552922511386414,0.2014957695955512,1,3,0
3,8,0,2,1,0.0,0,0,11,0,France,217,1.5799460760545467,-0.1902221075939572,1,3,3
21,9,11,19,12,100.0,0,7,30,11,France,16,-1.3758915175919757,0.722975918727564,0,0,1
9,8,5,3,1,100.0,1,0,17,6,UK,236,-0.6143876694399985,0.03212694742103959,0,0,1
6,8,107,0,1,0.0,3,0,14,110,Italy,28,-0.06622261178328057,-1.3390590474339998,3,0,2
25,8,0,0,2,100.0,0,0,33,0,France,319,0.18420714245324657,1.8092988262659722,2,3,0
7,8,0,0,7,100.0,0,0,15,0,France,11,0.4628210773959808,1.590380671595973,2,3,0
7,8,1,0,1,0.0,0,0,15,1,Italy,666,0.41946712927101826,-0.5552771617958514,3,0,2
4,9,334,0,2,0.0,1,4,13,335,Italy,34,-0.7367801938552606,-1.578339563394439,3,0,1
7,8,0,0,3,66.0,0,0,15,0,UK,61,0.6394881116780605,1.2009368509389091,2,3,0
4,13,142,0,1,0.0,2,6,17,144,Spain,11,-0.6924796430894867,-2.011006854143516,3,0,2
4,8,26,0,1,0.0,1,0,12,27,France,233,0.21068407685096288,-1.40335349502603,3,0,2
3,9,0,1,1,0.0,0,0,12,0,France,76,1.2965149917193006,-0.1780780929311503,1,3,3
30,8,0,7,4,100.0,0,0,38,0,Chypre,17,-0.160634683734966,2.261821375895364,2,3,0
8,8,475,1,1,0.0,11,10,16,486,Germany,11,-0.8165398126204557,-1.6359389432382252,3,0,2
26,8,0,3,5,40.0,0,0,34,0,Italy,271,0.04650891020744693,1.86520232598959,2,3,0
40,9,51,1,6,0.0,7,33,49,58,Germany,14,-1.566608682600384,-0.6301461984343389,0,0,1
11,8,0,1,2,0.0,0,0,19,0,UK,419,0.45929351398715673,1.221762432609259,2,3,0
42,8,0,55,54,100.0,0,0,50,0,UK,23,-0.3556186992167664,2.547988754512359,2,3,0
5,8,0,0,1,0.0,0,0,13,0,UK,54,1.2296015562652727,0.131225121925935,1,3,0
23,8,0,0,4,100.0,0,0,31,0,France,367,0.17909196300167118,1.8404022787686034,2,3,0
3,8,0,0,1,0.0,0,0,11,0,France,380,1.8211872325051175,-0.5087243978983353,1,3,3
25,8,0,0,4,100.0,0,0,33,0,Italy,147,0.15867059160627084,1.8594504502276783,2,3,0
6,8,14,1,1,0.0,11,1,14,25,UK,11,-0.4937778608099259,-1.4491281020427929,3,0,2
7,8,0,0,1,0.0,0,0,15,0,Germany,654,1.0955486418094456,0.25771400110501996,1,3,0
3,8,0,0,2,100.0,0,0,11,0,France,534,1.230865903815774,0.7406600157047611,1,3,3
44,8,14,0,18,78.0,9,3,52,23,Italy,61,-1.3073069424501103,-0.22663370513915188,0,0,1
4,8,51,2,2,100.0,27,1,12,78,France,17,-0.9867691506703977,-0.45319171369601063,0,0,1
7,8,2,8,4,75.0,1,0,15,3,France,21,-0.6758270001665232,0.28230208871970025,0,0,1
17,8,5,1,4,100.0,0,0,25,5,France,53,-0.7272119389662832,1.1894265436173528,2,0,1
4,8,0,0,3,100.0,0,0,12,0,France,610,0.7359512465560571,1.305360316125623,2,3,0
6,8,0,0,1,0.0,0,0,14,0,France,657,1.1552922511386414,0.2014957695955512,1,3,0
9,8,808,3,1,0.0,5,16,17,813,US,13,-0.9070758227348672,-1.6178164479606492,3,0,2
3,9,30,0,1,0.0,0,0,12,30,Finland,13,0.703313576785198,-1.4663383715362204,3,0,3
4,8,0,0,2,0.0,13,0,12,13,Germany,252,0.3143340642195796,-0.4371630785281827,3,0,1
41,8,0,23,43,78.0,0,0,49,0,France,11,-0.1775543889653239,2.175800360266618,2,3,0
7,8,0,0,1,0.0,0,1,15,0,US,670,0.827911820168421,-0.22988848239912998,1,3,0
12,8,5,1,13,100.0,0,0,20,5,Monaco,19,-0.6878116510040183,1.191392353709745,2,0,1
27,8,0,3,2,0.0,0,0,35,0,Spain,444,0.23403294890598245,1.442052129783009,2,3,0
3,8,0,0,1,0.0,0,0,11,0,France,707,1.8211872325051175,-0.5087243978983353,1,3,3
3,8,1,3,1,0.0,0,0,11,1,Italy,34,0.8952545751914592,-0.9918458030143782,3,0,3
5,8,0,0,1,0.0,0,0,13,0,US,704,1.2296015562652727,0.131225121925935,1,3,0
6,8,0,0,1,0.0,0,0,14,0,Spain,689,1.1552922511386414,0.2014957695955512,1,3,0
6,8,20,6,9,88.0,10,0,14,30,Italy,13,-0.7746584848159047,0.10966295175035737,0,0,1
24,8,1,3,3,100.0,1,0,32,2,UK,424,-1.0793069359273055,0.8828420150989084,0,0,1
7,8,1,0,3,100.0,0,0,15,1,France,407,-0.18649555355551245,0.7248255471495074,2,0,1
7,8,14,0,9,88.0,0,1,15,14,France,25,-0.45658972221569993,-0.14068646844885732,0,0,1
43,8,5,1,4,0.0,0,0,51,5,Italy,448,-0.6147110489808931,0.6699313678194913,2,0,1
20,8,0,0,1,0.0,0,0,28,0,Spain,264,0.8261692431966422,0.5112159095950015,1,3,0
12,8,0,1,2,0.0,0,0,20,0,UK,62,0.4357854572733051,1.2439766939744141,2,3,0
23,10,67,2,5,60.0,6,3,33,73,Denmark,19,-1.6414492137252594,-0.3054048077478351,0,0,1
48,16,599,22,82,89.0,1016,32,64,1615,Germany,11,-2.361929463243438,-0.3247805610895805,0,0,1
3,8,7,0,1,0.0,0,0,11,7,Denmark,43,1.0654312860744517,-1.4174186489287324,3,0,3
3,8,3,0,1,0.0,16,0,11,19,Germany,171,0.6984896091437164,-1.9382422087068991,3,0,3
8,8,0,0,1,0.0,0,0,16,0,Austria,130,1.049729557348179,0.3009051053742676,1,3,0
46,192,274,22,9,88.0,47,0,238,321,Italy,11,-2.1172570222996914,0.3829949471893897,0,0,1
30,8,0,1,3,100.0,0,0,38,0,Italy,301,-0.10850581664149575,2.1866284043398734,2,3,0
3,8,0,0,1,0.0,0,0,11,0,France,48,1.8211872325051175,-0.5087243978983353,1,3,3
9,8,9,0,4,100.0,2,3,17,11,UK,29,-0.983331113349266,-0.2771449205361977,0,0,1
5,8,0,0,1,0.0,0,0,13,0,Germany,706,1.2296015562652727,0.131225121925935,1,3,0
3,8,32,2,1,0.0,40,4,11,72,Germany,13,0.06730779325456925,-2.271452249619877,3,0,3
3,8,3,1,1,0.0,0,0,11,3,Denmark,55,0.8723908107945081,-1.0745949261466483,3,0,3
79,421,1751,4,10,77.7,299,0,500,2050,Spain,55,-2.331515508169045,0.18339453364532732,0,0,1
4,8,0,6,1,0.0,0,0,12,0,Italy,13,1.0757364739826691,0.3766824238227612,1,3,0
3,8,0,0,1,0.0,0,0,11,0,France,698,1.8211872325051175,-0.5087243978983353,1,3,3
21,8,0,0,2,100.0,0,0,29,0,France,546,0.22548271924700314,1.7705444769131977,2,3,0
4,8,16,1,1,0.0,0,0,12,16,France,20,0.32261744692058014,-0.6253471499604938,3,0,2
4,8,11,0,1,0.0,0,0,12,11,France,34,0.5684078948964049,-0.9047834538330682,3,0,2
27,12,4,1,1,0.0,0,0,39,4,US,209,-0.49212233174425885,-0.10245103287376688,3,0,2
4,12,5,4,4,100.0,11,0,16,16,Italy,11,-1.117067442277904,0.2868461851787371,0,0,1
8,20,9,4,3,66.0,141,3,28,150,Portugal,32,-1.6563989371843844,-0.5258643510542907,0,0,1
10,9,35,8,10,100.0,14,0,19,49,Spain,12,-1.3149262680223368,0.4949705754331292,0,0,1
3,8,0,0,1,0.0,0,0,11,0,France,11,1.8211872325051175,-0.5087243978983353,1,3,3
5,8,0,0,6,83.0,0,0,13,0,France,45,0.7450409540053234,1.1322350279496767,2,3,0
9,8,1,0,1,0.0,1,0,17,2,UK,707,0.008631232753040907,-0.9454722549639206,3,0,2
5,7,0,0,1,0.0,0,0,12,0,France,676,1.5764075503289354,0.19238382440277657,1,3,2
19,8,1,15,30,83.0,0,1,27,1,Italy,13,-0.9323266697302391,0.6852767793803074,0,0,1
4,8,60,0,3,66.0,1,0,12,61,Austria,53,-0.2877797198842009,-0.5110611251555923,3,0,1
9,8,7,21,5,100.0,12,0,17,19,Italy,11,-1.0387106381704536,0.5964496885714701,0,0,1
24,9,0,2,3,0.0,0,0,33,0,UK,227,0.08148052785711633,1.3632060517318496,2,3,0
4,8,4,0,1,0.0,0,0,12,4,France,72,0.6087700080331391,-0.8562572957047052,3,0,2
3,8,4,1,1,0.0,2,0,11,6,Italy,90,0.5254568972267871,-1.5625485824404821,3,0,3
36,15,3,0,9,100.0,1,0,51,4,US,304,-1.303362377461179,0.548689325296259,0,0,1
22,9,1,0,1,0.0,0,0,31,1,US,695,-0.04403963202599185,-0.35423146280278933,3,0,2
8,8,5,0,2,100.0,3,0,16,8,UK,369,-0.6251954972537535,0.17400019622544521,0,0,1
52,44,73,15,19,100.0,3,3,96,76,UK,13,-2.250596560218909,0.3232892253617887,0,0,1
12,8,133,2,4,100.0,0,4,20,133,UK,12,-1.1134104187847182,0.41120766148709714,0,0,1
27,8,24,0,1,0.0,0,0,35,24,France,62,-0.054024303925024546,-0.3977966954281123,3,0,2
9,8,0,0,1,0.0,0,0,17,0,US,705,1.0151362757601365,0.3336331340255292,1,3,0
3,4,4,0,1,0.0,1,6,7,5,Netherlands,81,0.9863590805043371,-2.4412015123541404,3,0,3
10,8,0,0,2,100.0,0,0,18,0,US,618,0.3964327521554105,1.6096760028790882,2,3,0
43,23,894,3,8,62.5,290,174,66,1184,US,11,-2.2670578075084835,-0.6108722453376463,0,0,1
11,16,21,0,1,0.0,28,2,27,49,Australia,11,-0.897385428831485,-1.7094635022925795,3,0,2
8,8,1,0,1,0.0,2,0,16,3,Netherlands,47,0.0251733179139452,-1.0023619822873522,3,0,2
4,8,0,2,1,0.0,0,1,12,0,UK,17,0.8330359512909932,-0.14384258601950745,1,3,0
5,9,0,0,1,0.0,0,0,14,0,UK,132,1.0117480335209161,0.0957250493748099,1,3,0
46,41,70,0,1,0.0,67,5,87,137,Hong Kong,258,-1.3487754924551174,-1.5825535129188333,0,0,2
4,8,1,1,2,0.0,0,0,12,1,France,597,0.16529473978519507,0.048577295124596,3,0,1
26,8,0,4,10,100.0,0,0,34,0,Spain,36,-0.1366565188219241,2.264096909058601,2,3,0
3,8,0,0,1,0.0,0,0,11,0,UK,102,1.8211872325051175,-0.5087243978983353,1,3,3
22,8,16,0,4,75.0,0,1,30,16,UK,181,-0.7216714368859828,0.06059561037569149,0,0,1
5,8,0,0,1,0.0,0,0,13,0,France,383,1.2296015562652727,0.131225121925935,1,3,0
3,8,1,2,2,100.0,0,0,11,1,France,647,0.3135432348267762,0.24617114310826768,2,0,3
4,8,3,1,2,100.0,0,0,12,3,France,47,-0.19720382101736442,0.7087714925350475,2,0,1
3,8,0,0,1,0.0,0,0,11,0,France,695,1.8211872325051175,-0.5087243978983353,1,3,3
4,8,1,0,1,0.0,0,0,12,1,France,666,0.6658324168441601,-0.7877335557206065,3,0,2
29,8,12,0,6,100.0,8,4,37,20,Spain,14,-1.3206817068158367,-0.056029172553625384,0,0,1
58,34,148,22,10,100.0,2,3,92,150,Italy,11,-2.2569819172539285,0.26819387126284283,0,0,1
5,8,64,2,4,75.0,0,4,13,64,Denmark,25,-0.6317114574564332,-0.1454443608970972,0,0,1
12,8,3,0,6,66.0,3,0,20,6,France,372,-0.6091288579938361,0.03865000998805148,0,0,1
37,9,122,23,27,85.0,0,0,46,122,Italy,11,-1.2163061669600221,0.9884597422127794,0,0,1
15,8,6,7,11,100.0,44,1,23,50,France,13,-1.4781335520756484,0.18929963145034248,0,0,1
4,8,0,3,1,0.0,0,0,12,0,Italy,516,1.0920627846073578,0.3551273649650929,1,3,0
27,10,10,0,1,0.0,0,0,37,10,Italy,601,-0.24110588251063247,-0.43752622910313194,3,0,2
7,8,0,3,4,60.0,0,0,15,0,Spain,12,0.38164795876930485,1.5459560993364176,2,3,0
49,35,1,0,4,100.0,0,0,84,1,Italy,18,-1.0684722107961533,1.06067910684214,0,0,1
8,9,2,3,2,0.0,0,0,17,2,France,41,-0.36750743188829554,0.2602757961004536,2,0,1
15,19,0,5,2,0.0,149,22,34,149,UK,12,-1.2270608673540864,-0.46068677433088995,0,0,1
4,8,18,0,1,0.0,5,3,12,23,Spain,114,-0.08741868282256518,-1.9443994834931533,3,0,2
35,11,8,2,27,55.0,1,0,46,9,Netherlands,30,-1.4027316515181476,0.5577893404926512,0,0,1
9,11,10,10,6,50.0,0,0,20,10,France,661,-0.8046591158890889,0.6875824926718832,0,0,1
37,11,143,2,5,60.0,14,2,48,157,Sweden,17,-1.8257719868781213,-0.28114677435808944,0,0,1
8,8,1,0,1,0.0,1,1,16,2,France,634,-0.2244123072999417,-1.4658027671193326,3,0,2
6,8,1,0,1,0.0,0,0,14,1,France,584,0.479210738600214,-0.6114953933053203,3,0,2
3,8,0,2,1,0.0,0,0,11,0,Italy,11,1.5799460760545467,-0.1902221075939572,1,3,3
42,8,1,22,11,90.0,1,0,50,2,Italy,25,-1.1525989009422863,0.8320185872292667,0,0,1
13,8,0,3,3,100.0,0,0,21,0,Italy,41,0.05987036225852923,2.0372368543881096,2,3,0
4,8,2,1,1,0.0,3,0,12,5,Italy,15,0.05861275449191916,-1.0152831048148048,3,0,2
7,8,1,0,1,0.0,0,0,15,1,France,706,0.41946712927101826,-0.5552771617958514,3,0,2
6,8,0,0,1,0.0,0,1,14,0,US,681,0.887655429497617,-0.2861067139085986,1,3,0
4,8,0,0,1,0.0,0,0,12,0,France,676,1.3419139293825877,0.02525760718026462,1,3,0
8,9,3,7,14,100.0,0,0,17,3,France,27,-0.7881383474099234,1.112232776536235,2,0,1
9,13,7,0,1,0.0,4,1,22,11,Spain,180,-0.7092779856482977,-1.6141294527512435,3,0,2
7,8,1,0,1,0.0,0,0,15,1,Netherlands,617,0.41946712927101826,-0.5552771617958514,3,0,2
6,8,3,0,1,0.0,1,0,14,4,Austria,273,0.11223076097302857,-1.1212429787612535,3,0,2
11,15,2,0,2,50.0,0,0,26,2,Italy,201,-0.5478649397477411,0.3725065544257705,2,0,1
13,12,6,1,6,100.0,0,0,25,6,UK,14,-0.9889596128324653,1.0617878287819105,2,0,1
14,37,4,4,8,87.0,0,0,51,4,UK,11,-1.1178290602902985,0.8951507604967589,0,0,1
8,8,312,1,5,60.0,123,18,16,435,Ireland,14,-1.3221220473549171,-0.7203459113940044,0,0,1
4,13,14,4,1,0.0,11,0,17,25,Germany,114,-0.5718052675171235,-1.0379502841665125,3,0,2
5,8,0,2,1,0.0,0,0,13,0,UK,42,0.9883603998147029,0.44972741223031226,1,3,0
4,8,0,0,1,0.0,0,0,12,0,France,285,1.3419139293825877,0.02525760718026462,1,3,0
63,8,2,7,49,86.4,0,0,71,2,Italy,12,-0.9539478316132682,1.396475375864316,2,0,1
6,10,13,4,5,80.0,117,85,16,130,Finland,11,-1.4588526954318142,-0.7284628626804907,0,0,1
11,8,17,0,4,75.0,1,0,19,18,France,12,-0.6207693094158007,-0.050130422175479646,0,0,1
32,8,0,0,2,100.0,0,0,40,0,Germany,430,0.11722813304492613,1.8722548213209955,2,3,0
44,8,1,0,15,31.0,0,0,52,1,Italy,26,-0.535513129105289,0.9063734582856587,2,0,1
5,8,0,0,1,0.0,0,0,13,0,France,632,1.2296015562652727,0.131225121925935,1,3,0
4,8,0,1,2,0.0,0,0,12,0,Italy,633,0.8413762523236232,0.8615684580254667,1,3,0
8,8,1,2,12,75.0,0,0,16,1,Italy,19,-0.3719800875621875,0.845401677665957,2,0,1
26,10,2,0,1,0.0,27,1,36,29,Italy,37,-0.863536431142886,-1.4522537521964545,3,0,2
8,11,3,10,4,100.0,0,0,19,3,Sweden,13,-0.8708140481719137,1.0405129138483715,2,0,1
3,8,0,0,1,0.0,0,0,11,0,France,263,1.8211872325051175,-0.5087243978983353,1,3,3
103,431,7,13,66,93.0,0,0,534,7,Italy,15,-1.720115175850094,1.3381926336917682,0,0,1
6,8,0,0,8,88.0,0,0,14,0,UK,189,0.6593178009003284,1.2258091718661928,2,3,0
4,8,0,0,3,100.0,0,0,12,0,France,458,0.7359512465560571,1.305360316125623,2,3,0
4,8,0,0,2,100.0,0,0,12,0,US,377,0.751592600693245,1.2746420207833602,2,3,0
5,8,0,0,1,0.0,0,0,13,0,France,383,1.2296015562652727,0.131225121925935,1,3,0
10,7,3,3,1,0.0,236,81,17,239,UK,11,-0.5712316763676178,-1.4313111939125243,3,0,2
7,8,0,2,4,75.0,0,0,15,0,Portugal,63,0.3853401228791967,1.5456406140911736,2,3,0
7,10,1,0,14,92.0,0,1,17,1,France,120,-0.6381048679897028,-0.02652119892666243,0,0,1
4,8,0,0,2,0.0,0,0,12,0,Italy,120,1.0692993892522245,0.5606494846910298,1,3,0
12,8,0,7,10,75.0,0,0,20,0,UK,11,0.1688817155100988,1.7893814618636046,2,3,0
28,8,87,0,1,0.0,0,3,36,87,Belgium,11,-0.41644237832726894,-0.9900607206632703,3,0,2
7,8,1,1,3,66.0,0,0,15,1,Spain,592,-0.2645165377889688,0.688864661372475,2,0,1
28,8,0,0,1,0.0,4,1,36,4,France,142,-0.23086395915063349,-0.8404194282017807,3,0,2
6,10,6,0,1,0.0,0,0,16,6,France,640,0.11696587056401168,-0.7388516356885866,3,0,2
32,11,0,17,3,66.0,0,0,43,0,Grèce,18,-0.28949349224413135,1.842993814863458,2,3,0
5,8,0,4,2,0.0,0,0,13,0,France,11,0.6998064959614984,1.0061634760914262,1,3,0
10,8,0,5,4,50.0,1,1,18,1,Ireland,17,-0.6667353641127084,0.29858107313560406,0,0,1
5,8,0,1,1,0.0,0,0,13,0,UK,455,1.0016784193366715,0.43214409526037173,1,3,0
5,8,0,0,1,0.0,0,1,13,0,Ireland,679,0.9619647346242479,-0.3563773615782149,1,3,0
85,0,115,54,73,90.0,4,0,85,119,Spain,11,-0.8411806027679044,1.1570751657145317,2,2,2
11,10,153,27,13,92.0,63,6,21,216,Belgium,11,-1.708630717606402,-0.4177481358740305,0,0,1
172,50,778,96,34,64.0,2,0,222,780,Italy,11,-2.183701265376939,0.6019761152221514,0,0,1
9,8,7,1,1,0.0,0,1,17,7,Luxembourg,15,-0.23617962924015487,-0.761744627174581,3,0,2
8,10,3,3,1,0.0,49,0,18,52,Austria,16,-0.6243858781557199,-0.9194273571210904,3,0,2
6,8,1,2,1,0.0,1,0,14,2,France,102,-0.09245394831902416,-0.7591073290895212,3,0,2
22,9,36,51,18,70.0,1,0,31,37,Italy,11,-1.3490502012698535,0.48732930502341304,0,0,1
5,8,0,0,1,0.0,0,0,13,0,UK,358,1.2296015562652727,0.131225121925935,1,3,0
11,10,14,5,18,83.0,19,0,21,33,UK,12,-1.2396909652290307,0.23735208175990485,0,0,1
7,8,0,1,3,100.0,0,0,15,0,France,379,0.261662822054314,1.8387356833848152,2,3,0
15,11,5,0,1,0.0,0,0,26,5,Belgium,586,-0.12558207967690452,-0.5270797318984767,3,0,2
12,11,6,1,8,100.0,5,0,23,11,Italy,12,-1.3075323194597015,0.5645159330067866,0,0,1
6,9,2,0,1,0.0,1,0,15,3,Slovaquie,19,-0.08203547207475533,-1.14770958306243,3,0,2
5,9,41,2,3,66.0,5,0,14,46,Italy,12,-0.8673216505037347,-0.13723880232431718,0,0,1
4,8,0,0,1,0.0,1,1,12,1,US,149,0.41288948303106215,-1.3369728085587682,3,0,2
3,8,0,1,2,100.0,0,0,11,0,France,138,1.0029427668871729,1.0415789890391978,2,3,3
8,10,16,1,1,0.0,0,0,18,16,France,30,-0.2281432896350163,-0.41421331651305154,3,0,2
11,11,159,1,11,90.9,11,1,22,170,Italy,13,-1.5962841525734282,-0.4311322805421378,0,0,1
4,9,4,1,9,100.0,0,1,13,4,France,11,-0.7722646411208515,0.2918427400391014,0,0,1
6,8,1,0,1,0.0,0,0,14,1,Italy,460,0.479210738600214,-0.6114953933053203,3,0,2
8,10,45,0,1,0.0,4,10,18,49,Germany,105,-0.7003847988166045,-1.8213009244362253,3,0,2
6,8,2,2,1,0.0,0,0,14,2,Italy,477,0.20932416198453016,-0.327401426360953,3,0,2
12,11,0,1,5,100.0,1,22,23,1,France,44,-1.1781473007870222,0.47188159574223476,0,0,1
3,8,5,5,1,0.0,0,0,11,5,France,21,0.8170049170371929,-1.0546484311450424,3,0,3
21,8,1,5,29,100.0,0,0,29,1,UK,198,-0.8016813521241538,1.4782738879043156,2,0,1
3,8,0,0,1,0.0,0,0,11,0,France,694,1.8211872325051175,-0.5087243978983353,1,3,3
4,8,0,0,1,0.0,0,0,12,0,Italy,424,1.3419139293825877,0.02525760718026462,1,3,0
5,8,0,3,1,0.0,0,0,13,0,UK,427,0.9797504114900428,0.4610948797107632,1,3,0
3,8,0,0,2,0.0,0,2,11,0,Italy,15,1.269558496894199,-0.48166322695868863,1,3,3
28,9,42,1,5,80.0,0,0,37,42,France,24,-0.9726362685966362,0.7928940760851421,0,0,1
4,8,0,0,1,0.0,0,0,12,0,UK,662,1.3419139293825877,0.02525760718026462,1,3,0
5,8,1,4,1,0.0,0,0,13,1,UK,15,0.29633952355343396,-0.3422195643202103,3,0,2
4,8,0,18,18,84.0,0,0,12,0,Italy,29,0.5299288628290765,1.4822782029984267,2,3,0
14,8,0,13,11,100.0,0,0,22,0,France,28,-0.032828375247764496,2.1805933804674402,2,3,0
5,10,9,0,1,0.0,1,0,15,10,France,23,-0.16280064762684535,-1.2635537375515322,3,0,2
6,8,51,6,6,85.0,29,14,14,80,UK,14,-1.1426292295646725,-0.5766220442011915,0,0,1
7,8,0,0,12,91.0,0,0,15,0,Italy,295,0.582275623721508,1.316669330209745,2,3,0
15,8,1,3,11,100.0,0,0,23,1,Italy,12,-0.6890551436787908,1.3356160832073634,2,0,1
3,8,0,0,2,0.0,0,0,11,0,Italy,305,1.5485726923747531,0.026667479612430312,1,3,3
7,8,0,0,2,100.0,0,0,15,0,France,272,0.505227313120103,1.5070984147081166,2,3,0
52,8,0,32,55,100.0,0,0,60,0,UK,86,-0.39492693714378,2.5813215797242988,2,3,0
6,8,25,2,8,100.0,14,2,14,39,UK,27,-1.1860208753816817,-0.15126874452605205,0,0,1
6,8,0,0,3,100.0,0,0,14,0,France,332,0.5493295683121115,1.4815984785409098,2,3,0
7,8,0,0,1,0.0,0,0,15,0,France,29,1.0955486418094456,0.25771400110501996,1,3,0
89,61,10,1,14,91.6,0,0,150,10,Spain,11,-1.418755301607554,1.0944077665062273,0,0,1
4,8,2,0,1,0.0,0,1,12,2,Italy,324,0.3695501750380214,-1.3097443625847671,3,0,2
4,8,0,0,2,0.0,0,0,12,0,France,44,1.0692993892522245,0.5606494846910298,1,3,0
10,12,182,0,2,0.0,2,5,22,184,France,89,-1.1504996350628491,-1.287065034506683,0,0,1
4,8,24,0,1,0.0,3,3,12,27,Sweden,30,-0.09004063843499008,-1.9456872900028068,3,0,2
7,12,42,0,1,0.0,2,1,19,44,Italy,15,-0.6950239041110846,-1.7472265275685814,3,0,2
24,8,6,4,5,100.0,12,0,32,18,UK,22,-1.2273476571257294,0.7689986612547285,0,0,1
6,8,19,0,2,100.0,0,0,14,19,US,153,-0.23336095436653073,0.49095638966095434,2,0,1
4,8,0,0,1,0.0,0,0,12,0,US,650,1.3419139293825877,0.02525760718026462,1,3,0
6,8,0,0,1,0.0,0,0,14,0,UK,689,1.1552922511386414,0.2014957695955512,1,3,0
12,8,1,8,13,90.9,0,0,20,1,France,15,-0.5291265329618621,1.019756814438831,2,0,1
19,8,125,7,6,100.0,0,4,27,125,Germany,12,-1.252068066455459,0.5715447491312998,0,0,1
24,9,5,6,5,100.0,1,0,33,6,US,265,-1.3403680833327805,0.7986095754047875,0,0,1
5,8,3,0,1,0.0,23,2,13,26,Austria,524,-0.18585743325754495,-1.8246226912004828,3,0,2
8,9,1,1,1,0.0,1,17,17,2,Spain,13,-0.6937123342065904,-1.3168970002551865,3,0,2
15,8,0,0,3,100.0,0,0,23,0,France,250,0.27862764908331755,1.736743756832101,2,3,0
36,8,3,21,21,90.0,0,0,44,3,Lettonie,12,-0.8584222954230893,1.2558295978316607,2,0,1
3,8,1,0,1,0.0,0,0,11,1,Germany,129,1.145105719966689,-1.3217155607992064,3,0,3
5,8,0,0,3,100.0,0,0,13,0,France,58,0.6236388734387425,1.411327830871293,2,3,0
3,8,0,0,1,0.0,0,0,11,0,France,398,1.8211872325051175,-0.5087243978983353,1,3,3
14,8,0,20,22,100.0,0,0,22,0,Italy,12,-0.06394785986399433,2.2355556890492374,2,3,0
4,8,2,1,4,100.0,2,0,12,4,Italy,456,-0.5468334215966173,0.29820218637239826,2,0,1
4,8,4,1,4,50.0,1,0,12,5,UK,57,-0.4022413179332223,-0.055299069476571774,2,0,1
4,8,0,1,1,0.0,0,1,12,0,UK,23,0.8463539708129616,-0.16142590298944817,1,3,0
7,8,0,2,4,75.0,1,0,15,1,Netherlands,11,-0.2760475018313039,0.6710126818562905,2,0,1
96,0,3,0,50,96.0,214,32,96,217,Spain,13,-0.8686510983171096,0.10550498941290926,0,2,2
12,8,1,1,14,92.0,0,0,20,1,Germany,222,-0.4869574182846582,0.9664761466411659,2,0,1
13,8,2,3,1,0.0,0,0,21,2,Italy,17,-0.03889388761848201,-0.09026534081813078,3,0,2
4,8,208,1,1,0.0,31,11,12,239,Germany,11,-0.5044778725013086,-1.8931340828407242,3,0,2
38,30,61,2,3,100.0,11,0,68,72,Italy,15,-1.7959650705566783,0.5979101536683529,0,0,1
5,8,1,0,1,0.0,0,0,13,1,France,610,0.553520043726845,-0.6817660409749365,3,0,2
5,0,4,4,2,100.0,1,2,5,5,UK,26,0.2582353328080975,-0.17870385272067357,2,1,2
14,8,0,6,9,55.0,0,2,22,0,France,33,-0.13337086018392655,1.2906741975040132,2,3,0
3,8,0,2,1,0.0,0,0,11,0,France,111,1.5799460760545467,-0.1902221075939572,1,3,3
4,8,41,0,1,0.0,0,2,12,41,France,162,0.22413135560336145,-1.4916407774138003,3,0,2
4,8,0,0,1,0.0,0,2,12,0,UK,582,1.0628997339020334,-0.48307309939085386,1,3,0
4,8,1,0,2,0.0,0,0,12,1,France,203,0.3932178767137966,-0.2523416782098411,3,0,2
3,8,0,0,1,0.0,0,0,11,0,France,331,1.8211872325051175,-0.5087243978983353,1,3,3
4,8,0,1,1,0.0,0,0,12,0,France,234,1.1139907924539865,0.32617658051470155,1,3,0
3,8,4,0,1,0.0,0,0,11,4,France,21,1.0880433111556682,-1.3902393007833047,3,0,3
9,8,0,1,2,0.0,175,3,17,175,Germany,11,-0.6387792201536749,-0.49576285090541705,0,0,1
23,8,5,0,1,0.0,7,0,31,12,France,61,-0.31101937456317397,-0.8642401565093683,3,0,2
4,8,0,0,4,75.0,0,0,12,0,France,47,0.8729465669029091,0.9946819298620403,1,3,0
15,9,2,0,3,0.0,0,1,24,2,UK,244,-0.5525190031352177,-0.3819486262141423,0,0,1
5,8,11,18,1,0.0,38,1,13,49,Romania,14,-0.5160712093896765,-1.481925927867252,3,0,2
6,8,0,0,1,0.0,0,0,14,0,France,23,1.1552922511386414,0.2014957695955512,1,3,0
8,8,12,16,2,100.0,0,0,16,12,France,20,-0.6065093331167324,0.9957587550626461,2,0,1
5,8,0,4,8,87.0,0,0,13,0,France,51,0.4769965465170773,1.4938490568203775,2,3,0
5,8,16,1,2,0.0,0,0,13,16,UK,517,-0.06230946632709836,0.016012242295941927,3,0,1
15,8,41,1,1,0.0,6,1,23,47,Grèce,73,-0.795921095991233,-1.2291409198933942,3,0,2
5,8,0,2,1,0.0,0,0,13,0,France,630,0.9883603998147029,0.44972741223031226,1,3,0
13,29,320,3,1,0.0,24,8,42,344,Spain,11,-1.4585195481330124,-1.4996805327789362,0,0,2
7,8,0,0,2,100.0,0,0,15,0,UK,394,0.505227313120103,1.5070984147081166,2,3,0
4,8,0,1,1,0.0,0,0,12,0,France,14,1.1139907924539865,0.32617658051470155,1,3,0
16,8,128,9,3,100.0,0,7,24,128,Grèce,11,-1.2140333380980368,0.48340325467625056,0,0,1
21,2,61,11,11,100.0,225,1,23,286,France,24,-1.3332868336323058,0.2047538764743457,0,0,1
12,8,0,0,1,0.0,0,0,20,0,France,116,0.9363231343322702,0.40766584312921145,1,3,0
13,8,1,6,9,100.0,0,0,21,1,UK,11,-0.6670131781852158,1.313508140400402,2,0,1
10,8,7,8,9,50.0,6,2,18,13,Croatie,309,-1.1644892449848427,-0.19598851267924564,0,0,1
3,8,1,1,1,0.0,0,0,11,1,France,36,0.9171825830380879,-1.020796587464769,3,0,3
22,9,0,0,7,85.7,0,0,31,0,Italy,252,0.14080375954991442,1.4734526596147166,2,3,0
22,9,20,13,22,100.0,0,0,31,20,UK,14,-1.1234680461265965,1.2760240648297043,2,0,1
8,8,0,3,4,50.0,0,0,16,0,UK,23,0.3376301433189377,1.5850991546637136,2,3,0
18,8,1,4,18,100.0,0,0,26,1,Sweden,22,-0.7502290788358098,1.4121985186447985,2,0,1
5,8,1,0,1,0.0,0,0,13,1,Spain,687,0.553520043726845,-0.6817660409749365,3,0,2
31,13,9,1,5,66.0,0,0,44,9,Italy,484,-1.0431945953383184,0.8586770956877929,0,0,1
4,8,0,0,2,0.0,0,0,12,0,France,294,1.0692993892522245,0.5606494846910298,1,3,0
5,8,0,0,6,100.0,0,0,13,0,France,199,0.6015439620739484,1.454720366256142,2,3,0
13,8,3,0,1,0.0,1,0,21,4,UK,360,-0.12737730030532343,-0.8954743606988814,3,0,2
5,0,0,0,1,0.0,0,0,5,0,UK,343,2.438735218284603,0.07649590508851349,1,1,2
8,11,554,9,4,50.0,31,15,19,585,UK,11,-1.6706260237622772,-0.7333445907949976,0,0,1
8,14,10,0,1,0.0,2,6,22,12,France,42,-0.7363689265370555,-1.6841183030624631,3,0,2
4,9,95,0,1,0.0,119,7,13,214,Netherlands,12,-0.5050494618976574,-2.186665975092787,3,0,2
5,8,0,0,3,100.0,0,0,13,0,France,647,0.6236388734387425,1.411327830871293,2,3,0
13,8,0,0,4,100.0,0,0,21,0,France,430,0.299826310323971,1.7268004252227256,2,3,0
5,13,15,0,1,0.0,6,1,18,21,Belgium,41,-0.6221157305688142,-1.788886247820235,3,0,2
3,10,30,1,2,0.0,14,10,13,44,Denmark,11,-0.603835070142974,-1.6735081356348531,3,0,3
3,8,0,0,2,50.0,0,0,11,0,France,267,1.3844755140980816,0.39544826964457597,1,3,3
6,8,12,0,1,0.0,0,1,14,12,UK,16,0.10996799127287389,-1.2211776635708578,3,0,2
4,8,0,0,1,0.0,0,0,12,0,Belgium,533,1.3419139293825877,0.02525760718026462,1,3,0
9,8,36,0,3,66.0,3,1,17,39,Romania,34,-0.8755397045799814,-0.6858864460713477,0,0,1
16,8,1,11,3,66.6,0,0,24,1,US,442,-0.5447582862437648,0.9748504448849102,2,0,1
7,8,0,0,1,0.0,0,0,15,0,US,575,1.0955486418094456,0.25771400110501996,1,3,0
4,8,0,0,1,0.0,0,0,12,0,France,336,1.3419139293825877,0.02525760718026462,1,3,0
9,8,5,21,15,93.0,0,0,17,5,France,11,-0.5453136065837948,0.9096944051399896,2,0,1
62,209,1533,12,7,100.0,11,0,271,1544,Italy,11,-2.340840097608085,0.6049619229633032,0,0,1
8,10,6,3,10,90.0,7,2,18,13,Italy,11,-1.3540600745943907,-0.31111456694803563,0,0,1
3,8,26,1,1,0.0,1,2,11,27,France,11,0.18302004756433632,-2.1447472333413113,3,0,3
14,25,41,0,2,100.0,457,38,39,498,Italy,11,-1.8272909550977823,-0.6687811328816259,0,0,1
4,8,0,1,3,100.0,0,0,12,0,France,217,0.5080281096274559,1.6062792894600606,2,3,0
4,8,0,0,3,100.0,0,0,12,0,France,542,0.7359512465560571,1.305360316125623,2,3,0
7,8,0,0,5,0.0,0,0,15,0,Germany,21,0.790053235726252,0.8576811156821847,1,3,0
15,9,4,0,1,0.0,1,0,24,5,Swiss,471,-0.3458831956562978,-0.9488567707980292,3,0,2
3,8,8,1,1,0.0,8,0,11,16,UK,11,0.46874433638846735,-1.6355836749976471,3,0,3
4,8,0,0,1,0.0,0,0,12,0,Netherlands,584,1.3419139293825877,0.02525760718026462,1,3,0
10,9,0,0,1,0.0,0,0,19,0,France,46,0.8012776542156359,0.29802355450417256,1,3,0
5,8,0,0,1,0.0,0,0,13,0,France,671,1.2296015562652727,0.131225121925935,1,3,0
6,9,0,0,1,0.0,0,4,15,0,Sweden,328,0.6554720875732136,-0.37282573666990587,1,3,0
11,9,76,3,10,80.0,8,1,20,84,Spain,194,-1.459396838488158,-0.34949746143348326,0,0,1
38,9,0,5,28,96.0,0,0,47,0,Italy,14,-0.29416954856234556,2.0367745045587853,2,3,0
5,8,0,0,1,0.0,0,1,13,0,US,274,0.9619647346242479,-0.3563773615782149,1,3,0
5,0,2,0,1,0.0,0,0,5,2,Lettonie,447,1.7340082855810617,-0.7709035811723678,1,1,2
44,9,71,0,20,85.0,1,4,53,72,Germany,348,-1.5233155759372026,-0.33405027766369716,0,0,1
5,8,2,0,1,0.0,0,0,13,2,France,635,0.5248746235617314,-0.716174364334947,3,0,2
4,12,55,0,1,0.0,21,0,16,76,Denmark,83,-0.34956549760329886,-1.4813050419866345,3,0,2
7,11,399,0,2,100.0,4,74,18,403,China,38,-1.4660948793652977,-0.8222845179773068,0,0,1
5,9,0,0,1,0.0,0,0,14,0,France,17,1.0117480335209161,0.0957250493748099,1,3,0
3,8,6,0,1,0.0,0,3,11,6,UK,618,0.7858055402946403,-1.9308365456525285,3,0,3
3,8,1,1,1,0.0,0,0,11,1,France,187,0.9171825830380879,-1.020796587464769,3,0,3
4,8,23,0,3,100.0,1,0,12,24,Australia,17,-0.38998345374802323,-0.1168753999041196,2,0,1
11,8,150,1,2,100.0,5,33,19,155,France,11,-1.4417404106892338,-0.24837311967995615,0,0,1
4,8,0,1,2,0.0,0,0,12,0,UK,160,0.8413762523236232,0.8615684580254667,1,3,0
4,8,1,2,1,0.0,0,0,12,1,France,54,0.42459126039358996,-0.4692312654162288,3,0,2
20,9,7,0,11,90.0,1,0,29,8,Italy,26,-0.9304829867989887,0.1264332334087614,0,0,1
11,8,2,0,10,72.7,3,1,19,5,UK,324,-0.8594713393328841,-0.42081404111659027,0,0,1
3,8,0,0,1,0.0,0,0,11,0,France,672,1.8211872325051175,-0.5087243978983353,1,3,3
3,8,11,0,1,0.0,14,0,11,25,UK,106,0.6674409778405328,-1.974383841259029,3,0,3
6,8,3,0,1,0.0,0,0,14,3,Sweden,680,0.43441896635663396,-0.6652937319871992,3,0,2
6,8,2,0,1,0.0,0,0,14,2,Germany,90,0.4505653184351001,-0.6459037166653306,3,0,2
6,8,0,1,2,100.0,0,0,14,0,France,66,0.3370477855206974,1.751799156533084,2,3,0
7,8,0,1,2,0.0,0,0,15,0,Italy,233,0.5950109647504809,1.0940248519502225,2,3,0
7,9,27,3,2,100.0,0,1,16,27,France,11,-1.0263935428649298,0.31667998769420697,0,0,1
3,8,0,2,1,0.0,1,0,11,1,Italy,544,0.9185584513440467,-1.0648500398288405,3,0,3
4,8,0,1,2,100.0,0,0,12,0,UK,483,0.5236694637646434,1.5755609941177975,2,3,0
4,8,2,1,1,0.0,0,0,12,2,France,695,0.4092638597504449,-0.5212229057461801,3,0,2
3,8,0,0,1,0.0,0,0,11,0,Italy,605,1.8211872325051175,-0.5087243978983353,1,3,3
8,8,1,0,1,0.0,1,0,16,2,France,217,0.04322451434108317,-0.9782002836151824,3,0,2
3,8,0,0,1,0.0,0,0,11,0,France,632,1.8211872325051175,-0.5087243978983353,1,3,3
12,8,0,1,8,100.0,0,0,20,0,France,12,0.07206057315162272,2.0483448739007226,2,3,0
5,8,0,0,1,0.0,0,0,13,0,Spain,658,1.2296015562652727,0.131225121925935,1,3,0
4,8,0,2,2,50.0,0,0,12,0,UK,21,0.6639610545249821,1.2479325650275537,2,3,0
7,8,0,0,7,71.0,0,0,15,0,France,277,0.6109449037647986,1.2574973016042132,2,3,0
4,8,21,0,1,0.0,6,2,12,27,Spain,53,-0.0906603514174443,-1.9445114902988023,3,0,2
12,12,5,0,1,0.0,2,16,24,7,Germany,11,-0.7622820323603381,-1.6188854871959513,3,0,2
7,8,0,0,1,0.0,0,0,15,0,Italy,351,1.0955486418094456,0.25771400110501996,1,3,0
6,8,0,0,1,0.0,0,0,14,0,France,346,1.1552922511386414,0.2014957695955512,1,3,0
9,8,3,2,9,88.0,0,0,17,3,Spain,206,-0.44705159156586766,0.8177093665815788,2,0,1
10,8,42,0,1,0.0,6,2,18,48,Finland,101,-0.4785801333374802,-1.648767146905529,3,0,2
3,8,1,0,1,0.0,0,0,11,1,Italy,305,1.145105719966689,-1.3217155607992064,3,0,3
3,8,1,0,1,0.0,0,0,11,1,Italy,248,1.145105719966689,-1.3217155607992064,3,0,3
8,8,0,2,9,88.0,0,0,16,0,Sweden,12,0.30841497480418256,1.651770839513067,2,3,0
4,8,1,2,1,0.0,0,0,12,1,UK,21,0.42459126039358996,-0.4692312654162288,3,0,2
4,8,1,0,1,0.0,0,0,12,1,Belgium,704,0.6658324168441601,-0.7877335557206065,3,0,2
23,9,60,8,7,71.0,3,0,32,63,Italy,77,-1.3280360190117444,0.3274903450773177,0,0,1
4,8,0,0,1,0.0,0,0,12,0,France,179,1.3419139293825877,0.02525760718026462,1,3,0
6,8,1,0,2,50.0,13,2,14,14,France,31,-0.6480954056579936,-0.789620871273837,0,0,1
3,8,16,3,1,0.0,2,17,11,18,Italy,34,0.13185059303162056,-2.177916865000645,3,0,3
10,9,0,0,1,0.0,0,0,19,0,Italy,561,0.8012776542156359,0.29802355450417256,1,3,0
17,9,16,8,31,90.0,1,0,26,17,Spain,17,-1.2411580227775105,0.48556510189230745,0,0,1
19,9,11,22,11,81.0,8,0,28,19,Italy,16,-1.2731703628122157,0.4210230036440183,0,0,1
28,8,0,0,28,89.0,0,0,36,0,France,15,0.208768254404286,1.693007749185528,2,3,0
8,8,0,0,3,66.0,0,2,16,0,France,565,0.3146548317362393,0.7357972486370382,2,3,0
6,8,0,0,1,0.0,0,0,14,0,Germany,704,1.1552922511386414,0.2014957695955512,1,3,0
3,12,38,0,1,0.0,17,0,15,55,Lettonie,11,0.0510644124501858,-1.9094812838362205,3,0,3
6,10,0,4,3,0.0,23,1,16,23,France,20,-0.7261853469546692,-0.44964840650556614,0,0,1
5,8,3,0,2,0.0,0,0,13,3,Netherlands,421,0.23611373135290153,-0.2001725021460501,3,0,2
6,8,0,0,1,0.0,0,0,14,0,France,664,1.1552922511386414,0.2014957695955512,1,3,0
3,8,0,0,2,0.0,0,0,11,0,UK,57,1.5485726923747531,0.026667479612430312,1,3,3
7,8,0,2,7,85.0,0,0,15,0,Spain,22,0.3635778090104961,1.589766607228805,2,3,0
6,9,0,0,2,50.0,0,0,15,0,France,684,0.5102080071822845,1.062329892173755,2,3,0
7,9,2,0,6,66.0,3,0,16,5,Italy,162,-0.6362649229076572,-0.14881283070256568,0,0,1
5,8,0,0,1,0.0,0,1,13,0,Spain,659,0.9619647346242479,-0.3563773615782149,1,3,0
31,8,84,4,30,100.0,19,0,39,103,UK,14,-1.4683779837819142,0.8023200391046034,0,0,1
8,24,206,0,1,0.0,14,7,32,220,UK,75,-1.065544859284541,-1.8799297891979,0,0,2
3,9,0,4,3,100.0,0,0,12,0,France,20,0.6612949256479607,1.1406521193344974,2,3,3
6,8,18,11,1,0.0,5,0,14,23,Hong Kong,11,-0.269220092861503,-0.8757372204618089,3,0,2
4,8,0,1,1,0.0,0,0,12,0,France,83,1.1139907924539865,0.32617658051470155,1,3,0
10,8,6,3,1,0.0,0,0,18,6,Romania,271,-0.01243601811332746,-0.21081492486208564,3,0,2
5,8,0,4,3,100.0,0,0,13,0,France,112,0.3664583532653314,1.7508743075260196,2,3,0
10,8,7,0,4,100.0,0,0,18,7,France,614,-0.3848597451222306,0.7511333758103977,2,0,1
22,8,0,2,44,89.1,0,0,30,0,France,11,0.014559259546809871,1.9803707745504517,2,3,0
5,8,0,2,1,0.0,0,0,13,0,France,15,0.9883603998147029,0.44972741223031226,1,3,0
4,9,7,1,1,0.0,0,0,13,7,Italy,16,0.11319855554611628,-0.5955442236030308,3,0,2
5,8,8,6,3,100.0,12,4,13,20,France,11,-1.0725290911116978,-0.2149126935264924,0,0,1
14,9,1,1,1,0.0,0,0,23,1,Spain,14,-0.18083640146459953,-0.1393535550253082,3,0,2
4,8,3,6,4,100.0,18,1,12,21,UK,12,-0.9356759410222902,-0.24777901142519987,0,0,1
3,8,0,0,1,0.0,0,0,11,0,France,100,1.8211872325051175,-0.5087243978983353,1,3,3
14,8,1,5,11,100.0,0,0,22,1,Italy,11,-0.686142565268457,1.337543315210565,2,0,1
3,9,8,2,2,0.0,1,0,12,9,France,20,-0.06924253472193537,-0.9918973665151231,3,0,3
14,12,386,3,1,0.0,21,1,26,407,France,11,-1.2443852145421812,-1.484996156604057,0,0,2
6,8,0,0,1,0.0,11,2,14,11,France,11,0.129042755928506,-1.294373838903088,3,0,2
8,8,1,3,2,0.0,0,0,16,1,Croatie,422,-0.14881764009584247,0.3531755777689902,2,0,1
7,8,14,0,1,0.0,0,0,15,14,France,165,0.3111205255187515,-0.6854474287791298,3,0,2
5,8,0,0,1,0.0,0,0,13,0,US,611,1.2296015562652727,0.131225121925935,1,3,0
4,8,0,0,1,0.0,0,1,12,0,Germany,173,1.074277107741563,-0.46234487632388527,1,3,0
47,8,0,10,78,98.0,0,0,55,0,UK,13,-0.22083242349943602,2.243618183739162,2,3,0
5,10,12,6,1,0.0,3,4,15,15,France,15,-0.7518813019709004,-1.484555360117298,3,0,2
3,8,0,1,1,0.0,0,0,11,0,France,11,1.5932640955765158,-0.20780542456389847,1,3,3
4,8,0,0,1,0.0,0,0,12,0,France,574,1.3419139293825877,0.02525760718026462,1,3,0
48,8,0,19,3,0.0,0,0,56,0,Netherlands,545,0.04385891084012696,1.6553876029213639,2,3,0
4,8,0,0,1,0.0,0,0,12,0,France,408,1.3419139293825877,0.02525760718026462,1,3,0
5,8,3,1,6,83.0,0,0,13,3,Italy,11,-0.20375546770528594,0.5663644997013636,2,0,1
17,9,49,0,9,77.0,21,12,26,70,Italy,12,-1.3436614097535649,-0.6863648288265164,0,0,1
3,8,0,0,1,0.0,0,0,11,0,France,709,1.8211872325051175,-0.5087243978983353,1,3,3
22,8,0,27,16,100.0,0,0,30,0,France,653,-0.1588090437169055,2.319746476026743,2,3,0
16,8,33,10,20,79.0,1,0,24,34,France,17,-1.0745153658041782,0.4678249898014241,0,0,1
3,8,0,0,3,100.0,0,0,11,0,France,286,1.215224549678587,0.7713783110470233,1,3,3
6,8,7,4,12,83.0,1,0,14,8,Italy,19,-0.6849798940563703,0.2262605537599779,0,0,1
5,8,1,1,3,66.0,0,0,13,1,Italy,386,-0.13046362333314185,0.5623757821933897,2,0,1
40,10,83,0,7,0.0,0,0,50,83,UK,604,-0.7390311734457055,0.12897220329404713,0,0,1
6,10,9,4,3,100.0,1,1,16,10,Italy,13,-1.3483165399089427,-0.07741884693167363,0,0,1
5,8,0,0,1,0.0,0,0,13,0,France,638,1.2296015562652727,0.131225121925935,1,3,0
5,8,0,0,1,0.0,0,0,13,0,Italy,665,1.2296015562652727,0.131225121925935,1,3,0
8,8,0,7,8,100.0,0,0,16,0,France,28,0.14323332578384976,1.9973437790818254,2,3,0
4,8,1,0,1,0.0,0,0,12,1,France,595,0.6658324168441601,-0.7877335557206065,3,0,2
12,8,1,10,9,100.0,0,0,20,1,France,19,-0.6588817261650637,1.310422802202172,2,0,1
40,189,68,15,60,90.0,2,0,229,70,Lettonie,11,-2.004406085577779,0.6361637648450491,0,0,1
3,8,0,3,1,0.0,0,0,11,0,UK,114,1.5713360877298865,-0.17885464011350666,1,3,3
40,122,28,18,17,66.0,3,2,162,31,Italy,13,-2.13054065148986,0.056339518309357274,0,0,1
3,8,2,5,1,0.0,3,0,11,5,UK,13,0.5035924651911247,-1.503988475133815,3,0,3
8,10,70,2,6,100.0,49,8,18,119,Pologne,11,-1.640783195149414,-0.27160750786307863,0,0,1
4,8,3,0,3,100.0,0,0,12,3,France,14,0.015077961774049575,0.43857081454287294,2,0,1
16,2,91,5,5,80.0,10,1,18,101,Germany,11,-0.9807883555367254,-0.16594042966190106,0,0,1
11,23,334,0,1,0.0,84,2,34,418,France,11,-1.131883924836784,-1.8662210527321064,0,0,2
4,8,0,1,1,0.0,0,0,12,0,France,618,1.1139907924539865,0.32617658051470155,1,3,0
25,12,30,1,8,87.0,4,28,37,34,France,62,-1.7257512057849418,-0.2851111334754235,0,0,1
6,12,112,0,1,0.0,65,9,18,177,France,11,-0.8165586314285158,-2.0115148447142004,3,0,2
19,15,82,6,3,66.0,1,7,34,83,US,13,-1.7155575785719315,-0.34674661997067574,0,0,1
8,8,0,1,2,0.0,0,0,16,0,UK,175,0.549191880289214,1.1372159562194704,2,3,0
3,8,3,0,1,0.0,0,0,11,3,France,132,1.1003139477231094,-1.3755138994810856,3,0,3
6,8,1,0,5,100.0,0,0,14,1,US,25,-0.14399145604195956,0.7024642573641758,2,0,1
7,8,0,0,1,0.0,0,0,15,0,UK,700,1.0955486418094456,0.25771400110501996,1,3,0
11,9,34,11,13,92.0,9,1,20,43,France,14,-1.472973321084557,-0.23036777382287277,0,0,1
8,10,54,0,1,0.0,4,3,18,58,Italy,44,-0.685146609883312,-1.7888845488261664,3,0,2
4,8,0,0,2,100.0,0,0,12,0,US,91,0.751592600693245,1.2746420207833602,2,3,0
15,8,57,55,9,77.0,6,10,23,63,UK,11,-1.4379728411710366,-0.18042406823660148,0,0,1
3,11,21,0,1,0.0,0,0,14,21,Spain,11,0.5141612514741463,-1.3728804235466863,3,0,3
47,94,494,0,4,60.0,56,6,141,550,US,35,-2.007938918425752,-0.7188837077816845,0,0,1
5,8,13,7,7,87.0,0,0,13,13,Italy,11,-0.313295371052115,0.5649246120141669,2,0,1
22,8,21,0,10,100.0,0,0,30,21,France,11,-0.6418465819672794,0.9187345950398094,2,0,1
8,8,1,0,1,0.0,0,0,16,1,UK,187,0.3736480448097513,-0.5120860575266036,3,0,2
34,147,39,0,6,50.0,49,23,181,88,Slovénie,12,-1.94233556753001,-0.6019020697226584,0,0,1
17,8,6,17,19,100.0,1,0,25,7,Italy,12,-1.165501860627673,0.9063707867602,0,0,1
3,8,0,0,1,0.0,0,0,11,0,France,96,1.8211872325051175,-0.5087243978983353,1,3,3
7,10,19,5,2,100.0,109,3,17,128,UK,11,-1.5524995113608226,-0.29786138302355153,0,0,1
11,8,5,2,11,100.0,0,0,19,5,Italy,15,-0.6710883697954282,1.1739306711643647,2,0,1
5,8,1,0,2,0.0,0,0,13,1,Italy,236,0.2809055035964815,-0.14637416346417104,3,0,2
5,8,2,0,1,0.0,0,0,13,2,France,25,0.5248746235617314,-0.716174364334947,3,0,2
3,8,0,0,1,0.0,0,0,11,0,Australia,203,1.8211872325051175,-0.5087243978983353,1,3,3
6,8,1,1,3,100.0,0,0,14,1,Germany,18,-0.3546750811549179,0.9695262889744756,2,0,1
6,8,0,0,1,0.0,0,0,14,0,Spain,191,1.1552922511386414,0.2014957695955512,1,3,0
5,8,0,0,1,0.0,0,0,13,0,France,673,1.2296015562652727,0.131225121925935,1,3,0
6,8,0,0,1,0.0,0,0,14,0,Spain,670,1.1552922511386414,0.2014957695955512,1,3,0
4,8,0,0,1,0.0,0,1,12,0,France,254,1.074277107741563,-0.46234487632388527,1,3,0
6,8,0,3,1,0.0,0,0,14,0,France,284,0.9054411063634118,0.5313655273803796,1,3,0
3,9,64,8,2,100.0,408,17,12,472,Germany,11,-0.9959225885616437,-1.1505046764069382,0,0,3
19,8,3,2,12,91.0,0,0,27,3,Italy,11,-0.6395335716256182,1.0129977173687539,2,0,1
52,8,760,18,24,37.0,182,13,60,942,UK,12,-1.932501161647197,-0.19772434068766073,0,0,1
8,8,0,1,4,50.0,0,0,16,0,Spain,626,0.3595581511655666,1.5561483702133219,2,3,0
9,22,23,0,1,0.0,6,5,31,29,UK,98,-0.9169945956778423,-1.694623296416826,3,0,2
4,8,0,2,1,0.0,0,0,12,0,France,195,1.1006727729320176,0.3437598974846426,1,3,0
12,8,0,4,19,94.0,0,0,20,0,France,164,0.15008489268352426,1.8376717435832821,2,3,0
3,8,0,0,1,0.0,0,0,11,0,Germany,657,1.8211872325051175,-0.5087243978983353,1,3,3
3,8,9,9,5,60.0,131,3,11,140,Germany,23,-0.4429084949815737,-1.2591176142416902,3,0,3
8,8,3,2,2,100.0,8,1,16,11,France,242,-1.1445642803704,-0.011590909670892387,0,0,1
6,8,0,0,1,0.0,0,0,14,0,Sweden,672,1.1552922511386414,0.2014957695955512,1,3,0
4,8,9,1,4,25.0,1,0,12,10,France,157,-0.43016118814437604,-0.09544380756966359,0,0,1
10,8,5,48,26,95.0,3,1,18,8,Italy,11,-1.2188507589950373,0.02116526469039928,0,0,1
22,9,2,21,23,95.0,112,5,31,114,France,11,-1.6836520420709034,-0.10486284744769378,0,0,1
6,8,0,0,2,0.0,0,0,14,0,UK,377,0.8826777110082783,0.7368876471063167,1,3,0
6,8,2,0,1,0.0,0,0,14,2,France,546,0.4505653184351001,-0.6459037166653306,3,0,2
4,9,4,8,2,0.0,0,0,13,4,Italy,11,-0.18233390440664407,0.027138601344903587,3,0,1
3,8,1,0,1,0.0,0,0,11,1,Denmark,12,1.145105719966689,-1.3217155607992064,3,0,3
7,8,16,5,4,75.0,1,0,15,17,Italy,39,-0.7446614399855933,0.17145926226322858,0,0,1
14,12,10,2,2,0.0,1,0,26,11,Italy,284,-0.9988390238483104,-0.17165858759238237,0,0,2
3,8,0,0,1,0.0,0,0,11,0,France,328,1.8211872325051175,-0.5087243978983353,1,3,3
9,10,2,1,6,66.0,1,0,19,3,France,13,-0.9739059198516846,0.2470104436755756,0,0,1
4,8,1,0,6,50.0,0,0,12,1,France,297,0.19138443293514307,0.19054994254941574,2,0,1
4,8,2,0,1,0.0,2,0,12,4,France,473,0.2969475948683029,-1.3022528245268412,3,0,2
7,8,0,0,7,85.0,0,0,15,0,Italy,319,0.6048189654610661,1.2712643169244269,2,3,0
6,8,0,23,2,0.0,0,0,14,0,Netherlands,11,0.5833344464920904,1.132100125517438,2,3,0
4,8,0,0,1,0.0,0,0,12,0,France,617,1.3419139293825877,0.02525760718026462,1,3,0
6,8,1,0,1,0.0,0,0,14,1,France,372,0.479210738600214,-0.6114953933053203,3,0,2
11,8,98,0,1,0.0,68,17,19,166,Australia,14,-0.6428422259180546,-1.8226324138743408,3,0,2
11,18,7,0,1,0.0,1,5,29,8,France,15,-0.8194562721264569,-1.5757223785289745,3,0,2
9,26,86,1,4,75.0,2,1,35,88,France,254,-1.673912060019385,-0.4079756120811195,0,0,1
4,8,0,0,1,0.0,0,0,12,0,France,132,1.3419139293825877,0.02525760718026462,1,3,0
4,8,4,0,1,0.0,1,0,12,5,Ireland,146,0.2879300882493904,-1.3105423343156264,3,0,2
6,8,0,0,3,66.0,0,0,14,0,Ireland,334,0.6992317210072565,1.14471861942944,2,3,0
3,8,0,0,1,0.0,0,0,11,0,France,378,1.8211872325051175,-0.5087243978983353,1,3,3
3,8,0,0,2,100.0,0,0,11,0,France,16,1.230865903815774,0.7406600157047611,1,3,3
3,8,0,4,1,0.0,0,0,11,0,France,68,1.564006712331706,-0.1691779212436089,1,3,3
6,9,121,1,1,0.0,2,2,15,123,Luxembourg,33,-0.7828747291066082,-1.5901093201921899,3,0,2
6,8,1,0,2,0.0,0,0,14,1,France,379,0.20659619846985047,-0.07610351579455465,3,0,2
8,8,1,2,2,100.0,0,0,16,1,Italy,297,-0.4579144403301618,1.0558006463808705,2,0,1
4,8,0,0,3,0.0,0,0,12,0,Spain,330,1.0536580351150369,0.5913677800332924,1,3,0
3,8,0,0,1,0.0,0,0,11,0,France,376,1.8211872325051175,-0.5087243978983353,1,3,3
5,8,31,0,1,0.0,1,1,13,32,France,22,-0.1778441727149811,-1.7952911024449545,3,0,2
6,8,0,0,1,0.0,0,0,14,0,Netherlands,626,1.1552922511386414,0.2014957695955512,1,3,0
5,8,3,6,2,0.0,1,0,13,4,Italy,11,-0.35225192943062233,-0.3046969322776075,3,0,1
9,8,1,1,2,66.0,0,0,17,1,France,31,-0.3292875497010905,0.7340654989507222,2,0,1
4,8,0,0,1,0.0,3,2,12,3,UK,646,0.36346559863169303,-1.4076411713979649,3,0,2
4,8,0,0,1,0.0,0,0,12,0,France,44,1.3419139293825877,0.02525760718026462,1,3,0
8,8,0,0,1,0.0,0,0,16,0,Italy,45,1.049729557348179,0.3009051053742676,1,3,0
13,8,0,0,4,50.0,0,0,21,0,Italy,624,0.45343592060627863,1.3815886791625398,2,3,0
11,8,19,2,2,0.0,26,0,19,45,Portugal,66,-0.7449407635427971,-0.27328620255811076,0,0,1
4,8,2,1,2,0.0,0,0,12,2,Netherlands,411,0.13664931962008126,0.014168971764585404,3,0,1
22,11,22,6,11,81.0,2,0,33,24,Italy,20,-1.3631354371701043,0.3889642433239416,0,0,1
4,8,0,0,1,0.0,0,0,12,0,France,700,1.3419139293825877,0.02525760718026462,1,3,0
5,8,0,0,1,0.0,0,0,13,0,UK,672,1.2296015562652727,0.131225121925935,1,3,0
4,8,0,0,1,0.0,0,0,12,0,Italy,16,1.3419139293825877,0.02525760718026462,1,3,0
5,8,11,4,4,100.0,0,0,13,11,UK,34,-0.41694287793064,0.8402665751321312,2,0,1
7,8,262,0,1,0.0,312,9,15,574,France,40,-0.5917409467483142,-2.051631239864464,3,0,2
5,5,34,0,3,66.0,5,5,10,39,France,16,-0.021601485723163845,-1.1443245575428715,3,0,2
11,9,0,1,9,88.0,0,0,20,0,Spain,147,0.049463175042744285,1.6538989082088305,2,3,0
4,9,0,0,2,0.0,0,0,13,0,France,683,0.8242630987750195,0.5476229316036951,1,3,0
6,8,0,0,1,0.0,0,0,14,0,France,184,1.1552922511386414,0.2014957695955512,1,3,0
22,9,8,1,20,80.0,10,0,31,18,France,11,-1.2491599951021108,0.3976518349800753,0,0,1
4,8,1,0,1,0.0,0,0,12,1,France,275,0.6658324168441601,-0.7877335557206065,3,0,2
9,8,0,7,6,33.0,1,0,17,1,France,12,-0.38930472655353554,0.7904807753328942,2,0,1
4,8,0,0,2,0.0,0,0,12,0,France,139,1.0692993892522245,0.5606494846910298,1,3,0
6,8,0,0,1,0.0,0,0,14,0,France,395,1.1552922511386414,0.2014957695955512,1,3,0
7,8,688,0,1,0.0,2,2,15,690,France,11,-0.5085495661925025,-1.9145188984705537,3,0,2
26,8,0,0,2,0.0,0,0,34,0,US,626,0.4920845897876511,1.1047935925677044,2,3,0
5,8,0,0,2,0.0,0,0,13,0,UK,220,0.9569870161349094,0.6666169994367003,1,3,0
4,9,0,1,1,0.0,1,0,13,1,France,446,0.20756687726628095,-0.5614779048075165,3,0,1
3,8,1,0,1,0.0,0,0,11,1,UK,639,1.145105719966689,-1.3217155607992064,3,0,3
4,8,1,0,2,100.0,0,0,12,1,France,656,0.07551108815481697,0.46165085788248966,2,0,1
4,3,1,0,2,100.0,0,0,7,1,US,233,0.7325633976249039,0.30630733526042264,2,0,2
3,8,0,0,2,100.0,0,0,11,0,France,15,1.230865903815774,0.7406600157047611,1,3,3
9,8,0,5,10,100.0,0,0,17,0,France,26,0.10874441784168401,2.0349774594664916,2,3,0
4,8,0,1,1,0.0,0,0,12,0,France,651,1.1139907924539865,0.32617658051470155,1,3,0
3,8,5,0,1,0.0,0,0,11,5,Spain,11,1.079221646389118,-1.4008440392390689,3,0,3
3,8,3,0,1,0.0,0,0,11,3,France,36,1.1003139477231094,-1.3755138994810856,3,0,3
4,8,27,0,1,0.0,18,10,12,45,US,372,-0.16103453036953094,-2.0524483710665815,3,0,2
5,10,16,0,1,0.0,1,2,15,17,Germany,154,-0.4669994930559959,-1.802168928478316,3,0,2
4,8,0,1,3,66.0,1,1,12,1,France,37,-0.2710941840289246,-0.09283098539044186,0,0,1
4,8,0,1,1,0.0,0,0,12,0,France,131,1.1139907924539865,0.32617658051470155,1,3,0
8,8,3,2,5,83.0,2,1,16,5,Swiss,16,-0.9965779648701804,-0.21943893966997755,0,0,1
6,8,1,0,2,100.0,2,2,14,3,Austria,60,-0.7385995124654894,-0.36071761103409106,0,0,1
67,30,345,4,42,79.0,157,12,97,502,Bulgaria,11,-2.286070601476671,-0.22947246450671777,0,0,1
44,90,105,4,19,94.0,7,1,134,112,Italy,11,-2.158184431006545,-0.03791946219652908,0,0,1
6,8,0,0,3,66.0,0,0,14,0,France,26,0.6992317210072565,1.14471861942944,2,3,0
5,8,12,0,9,60.0,1,0,13,13,France,68,-0.3546987610368932,-0.24795790571378337,3,0,1
19,9,21,3,6,83.3,1,7,28,22,France,27,-1.496101829297397,-0.20496423102356381,0,0,1
16,9,0,4,12,91.0,12,279,25,12,France,11,-1.2023006018241449,0.11857825338444965,0,0,1
9,8,3,1,1,0.0,4,0,17,7,Denmark,54,-0.28824419247409144,-0.7320476539705733,3,0,2
3,8,2,1,1,0.0,0,3,11,2,France,13,0.6024944248453481,-1.576340786656067,3,0,3
4,8,9,2,2,0.0,1,2,12,10,Germany,105,-0.5347973026937388,-1.0007691168376396,3,0,1
3,8,1,0,2,0.0,2,1,11,3,Denmark,25,0.25637963129949487,-1.7642020915533392,3,0,3
6,9,221,2,2,0.0,1,6,15,222,Spain,11,-1.1157437504009384,-1.104238958125334,0,0,1
13,10,3,2,1,0.0,0,0,23,3,Spain,11,-0.28236156668702744,-0.20425842128794017,3,0,2
9,8,2,4,2,50.0,18,1,17,20,Italy,16,-1.064450318656213,-0.3350142916547146,0,0,1
7,8,0,0,2,100.0,0,0,15,0,France,25,0.505227313120103,1.5070984147081166,2,3,0
3,8,0,0,1,0.0,0,0,11,0,Italy,665,1.8211872325051175,-0.5087243978983353,1,3,3
7,8,14,4,3,100.0,1,0,15,15,UK,17,-0.8702520747785324,0.4831389233810902,0,0,1
6,8,9,0,2,0.0,9,0,14,18,UK,306,-0.2490904552604176,-0.7000841974074224,3,0,2
52,3,137,0,30,90.0,117,80,55,254,Luxembourg,11,-1.288175585271911,-0.35333774313350313,0,0,1
5,8,0,0,1,0.0,0,0,13,0,France,649,1.2296015562652727,0.131225121925935,1,3,0
11,9,3,0,1,0.0,0,0,20,3,France,568,0.05658645328276443,-0.5461730105427794,3,0,2
4,8,1,3,1,0.0,0,0,12,1,Italy,44,0.4159812720689298,-0.45786379793577814,3,0,2
4,8,0,0,1,0.0,0,0,12,0,US,251,1.3419139293825877,0.02525760718026462,1,3,0
3,9,5,0,1,0.0,0,0,12,5,France,319,0.782472542531903,-1.371116707606321,3,0,3
3,8,2,0,2,100.0,11,1,11,13,UK,29,-0.1334551498955897,-1.1433561484272192,3,0,3
5,8,11,0,2,100.0,4,15,13,15,UK,88,-0.7945042922106562,-0.6120277730064343,0,0,1
4,9,43,1,2,100.0,0,2,13,43,Singapour,13,-0.8417518720343655,0.042538322712719484,0,0,1
3,8,0,1,1,0.0,0,0,11,0,France,588,1.5932640955765158,-0.20780542456389847,1,3,3
5,9,1,0,1,0.0,2,0,14,3,UK,440,-0.012808205913317673,-1.2075420382868098,3,0,2
10,8,6,0,1,0.0,5,1,18,11,US,259,-0.38335092871651566,-1.5269116078617595,3,0,2
3,8,0,0,1,0.0,0,0,11,0,US,173,1.8211872325051175,-0.5087243978983353,1,3,3
10,11,85,1,8,25.0,104,1,21,189,Italy,23,-1.5695452101231004,-0.5426881707579584,0,0,1
15,10,1,0,1,0.0,0,0,25,1,US,634,-0.0243097315371005,-0.44215920969107936,3,0,2
8,10,42,0,1,0.0,17,2,18,59,US,54,-0.6995947279605967,-1.8077995239881386,3,0,2
7,15,0,0,1,0.0,14,0,22,14,US,30,-0.08760282693725072,-0.7660169088993335,3,0,2
28,11,2942,6,1,0.0,135,67,39,3077,Australia,11,-1.6183930777184166,-1.667932038467392,0,0,2
11,8,0,2,3,33.0,0,0,19,0,Spain,17,0.2677883756694573,1.6353582939553502,2,3,0
15,8,3,2,10,90.0,0,0,23,3,Italy,11,-0.5825470568285669,0.9507814468334242,2,0,1
3,8,121,0,1,0.0,0,0,11,121,France,58,0.9260961581374981,-1.58486430280817,3,0,3
7,1,5,1,7,100.0,13,1,8,18,UK,24,-0.32382790219666485,-0.3088449149528862,2,0,2
4,9,0,0,1,0.0,0,13,13,0,France,210,0.7837726481759484,-0.5582090301268343,1,3,0
4,8,0,1,3,100.0,0,0,12,0,France,46,0.5080281096274559,1.6062792894600606,2,3,0
6,8,0,0,4,100.0,0,0,14,0,Swiss,354,0.5394343716023231,1.5010318071603532,2,3,0
16,8,30,5,24,84.0,71,1,24,101,UK,11,-1.4277888436735218,-0.15272285351968923,0,0,1
3,8,0,1,1,0.0,3,0,11,3,France,43,0.8938299603061751,-1.1323734965710095,3,0,3
10,8,0,2,4,100.0,0,0,18,0,Luxembourg,13,0.12965504485786467,1.9783299171451731,2,3,0
3,8,1,0,1,0.0,0,0,11,1,France,569,1.145105719966689,-1.3217155607992064,3,0,3
12,12,196,0,3,100.0,69,58,24,265,US,12,-1.6382394150465802,-0.6920267689891237,0,0,1
6,8,0,1,1,0.0,0,0,14,0,UK,209,0.9273691142100404,0.502414742929988,1,3,0
3,8,1,0,1,0.0,0,0,11,1,France,686,1.145105719966689,-1.3217155607992064,3,0,3
25,8,0,1,1,0.0,0,0,33,0,Germany,170,0.5466053342139884,0.8608333859973121,1,3,0
8,11,2,0,1,0.0,0,0,19,2,UK,693,0.03987513129461841,-0.60757113136754,3,0,2
3,9,0,0,1,0.0,2,0,12,2,France,48,0.8388040420021288,-1.3854336018288267,3,0,3
26,8,1,2,2,100.0,0,0,34,1,France,28,-0.7429448677603263,1.3242972560635415,2,0,1
5,8,0,2,4,75.0,0,0,13,0,Austria,45,0.5193930373350237,1.4191517349120883,2,3,0
11,8,28,5,5,100.0,67,2,19,95,Portugal,30,-1.4375029943409396,-0.029101490763292583,0,0,1
15,8,3,1,5,80.0,0,0,23,3,UK,11,-0.5426187012708888,0.8793399507358017,2,0,1
4,8,0,7,2,100.0,0,0,12,0,Spain,11,0.4814357933809617,1.6313206370538451,2,3,0
7,8,164,0,1,0.0,30,10,15,194,Netherlands,18,-0.5061545018250092,-1.9400864813976235,3,0,2
8,8,162,0,1,0.0,4,4,16,166,Romania,11,-0.49346339995880284,-1.8080045789735995,3,0,2
10,8,6,0,5,100.0,0,0,18,6,Italy,17,-0.38578706798027057,0.7732749680225814,2,0,1
5,8,1,0,2,0.0,0,0,13,1,Germany,257,0.2809055035964815,-0.14637416346417104,3,0,2
9,8,0,2,10,83.0,0,0,17,0,UK,32,0.27321698267441435,1.6847988033703765,2,3,0
3,8,0,4,4,75.0,0,0,11,0,France,11,1.0950393498520272,0.8002464014381666,1,3,3
14,8,0,3,27,100.0,0,0,22,0,UK,62,-0.02607328088971841,2.18994024957603,2,3,0
3,8,0,0,1,0.0,0,0,11,0,Italy,709,1.8211872325051175,-0.5087243978983353,1,3,3
3,8,28,1,2,100.0,1,1,11,29,Spain,11,-0.3991534026146676,-0.8785050308571547,3,0,3
4,8,0,3,1,0.0,0,1,12,0,France,125,0.824425962966333,-0.13247511853905675,1,3,0
5,8,0,1,5,100.0,0,0,13,0,Italy,137,0.378476224694498,1.7461037459298678,2,3,0
13,8,2,10,1,0.0,0,0,21,2,Estonie,11,-0.06772769069499862,-0.05219707562998217,3,0,2
7,8,0,2,1,0.0,0,0,15,0,Grèce,30,0.854307485358876,0.5762162914093975,1,3,0
4,8,0,0,1,0.0,0,0,12,0,France,40,1.3419139293825877,0.02525760718026462,1,3,0
9,8,5,10,12,100.0,1,1,17,6,UK,11,-1.2444289985765686,0.23769735278391727,0,0,1
28,8,4,0,47,77.0,8,1,36,12,UK,21,-1.1709508628716239,-0.18287732625170267,0,0,1
3,8,0,0,1,0.0,0,0,11,0,France,685,1.8211872325051175,-0.5087243978983353,1,3,3
20,8,11,12,30,93.0,0,1,28,11,Italy,12,-1.0421284576628809,0.5869444611270523,0,0,1
4,8,0,2,2,100.0,0,0,12,0,France,119,0.5103514442426749,1.5931443110877388,2,3,0
11,9,20,1,8,62.0,1,1,20,21,Bulgaria,49,-1.322301328661145,-0.28054059937160875,0,0,1
6,12,52,2,1,0.0,446,8,18,498,Italy,11,-1.1071078325392132,-1.7616080041751256,0,0,2
6,8,1,0,2,100.0,0,0,14,1,Italy,225,-0.11111059008912907,0.637889020297776,2,0,1
6,8,69,6,2,100.0,8,4,14,77,Singapour,11,-1.2078721868044067,-0.2651047133218651,0,0,1
5,9,1,3,1,0.0,1,0,14,2,Italy,181,-0.24460815426140983,-0.8535105818298112,3,0,2
4,8,2,0,1,0.0,5,5,12,7,UK,11,-0.024591285810073565,-1.8756820913591108,3,0,2
13,8,40,14,8,62.0,0,0,21,40,Italy,198,-0.6933423636075982,0.7986340587306955,2,0,1
8,8,50,2,9,100.0,1,0,16,51,Italy,11,-0.9964810027450219,0.49857944050577074,0,0,1
3,8,1,0,1,0.0,0,0,11,1,France,226,1.145105719966689,-1.3217155607992064,3,0,3
3,8,0,0,1,0.0,0,0,11,0,UK,655,1.8211872325051175,-0.5087243978983353,1,3,3
6,10,9,1,1,0.0,2,0,16,11,UK,39,-0.4581850837271968,-0.9261346067264858,3,0,2
6,8,0,0,1,0.0,0,0,14,0,France,533,1.1552922511386414,0.2014957695955512,1,3,0
3,8,0,0,1,0.0,0,0,11,0,France,701,1.8211872325051175,-0.5087243978983353,1,3,3
31,27,161,4,24,100.0,612,20,58,773,Bulgaria,11,-2.3344430713461937,-0.09932804736356904,0,0,1
9,9,15,11,8,85.7,3,0,18,18,France,100,-1.0718697574107654,0.24067738729256086,0,0,1
18,16,52,0,18,100.0,4,48,34,56,Spain,12,-1.6974821829542692,-0.3267329898283643,0,0,1
12,8,0,6,6,33.0,0,0,20,0,UK,11,0.19724910864146333,1.7338876170434718,2,3,0
7,8,2,0,1,0.0,0,0,15,2,Croatie,500,0.39082170910590447,-0.5896854851558619,3,0,2
12,8,5,0,1,0.0,0,0,20,5,France,44,0.19435754821627116,-0.48445379821152246,3,0,2
34,8,6,7,11,83.0,0,0,42,6,Croatie,12,-0.8260315115314146,1.1274485016566262,2,0,1
4,8,1,1,3,33.0,0,0,12,1,France,84,-0.012892379010535656,0.4445898395007456,2,0,1
19,9,13,35,23,82.0,1,0,28,14,France,11,-1.2709470441486728,0.530235107339991,0,0,1
4,9,0,1,2,66.0,0,0,13,0,France,11,0.42853532598258365,1.225654581918994,2,3,0
15,8,0,10,38,84.0,1,0,23,1,France,11,-0.5998996453923218,1.0687633247951391,2,0,1
131,10,14,122,152,92.0,7,0,141,21,US,12,-1.8389238380005564,1.0072208418650963,0,0,1
13,9,1,0,1,0.0,1,1,22,2,Estonie,516,-0.5353539276245228,-1.4088052307638403,3,0,2
4,8,0,0,1,0.0,0,0,12,0,France,573,1.3419139293825877,0.02525760718026462,1,3,0
9,9,3,1,2,100.0,0,0,18,3,US,256,-0.7101786519500628,0.955474869641985,2,0,1
4,8,1,0,1,0.0,0,0,12,1,France,367,0.6658324168441601,-0.7877335557206065,3,0,2
5,8,1,10,11,90.0,0,0,13,1,Spain,71,-0.2337255413391921,0.7355473153128227,2,0,1
121,0,1140,31,108,94.0,531,105,121,1671,Sweden,11,-1.5124512669078158,0.26124475318807333,0,2,2
7,13,357,3,3,100.0,6,24,20,363,France,11,-1.7753795497613951,-0.403604564553797,0,0,1
6,8,3,1,1,0.0,47,13,14,50,France,13,-0.5498240993142517,-1.5515547182763956,3,0,2
4,8,4,0,1,0.0,3,0,12,7,France,12,0.26484712599710264,-1.3420127528021653,3,0,2
13,8,11,9,10,70.0,0,0,21,11,Italy,18,-0.6300490909034558,0.8839629562735014,2,0,1
7,8,1,16,2,100.0,0,0,15,1,US,12,-0.4590843229691504,1.0746474375547863,2,0,1
6,12,16,3,1,0.0,214,8,18,230,US,11,-1.0489719500824877,-1.6667232420402058,0,0,2
12,8,0,3,10,90.0,0,0,20,0,UK,13,0.1814490420512028,1.7799632111390944,2,3,0
15,15,22,1,2,0.0,2,4,30,24,UK,424,-1.3851228339234845,-0.7634262425630852,0,0,1
5,8,0,0,2,0.0,0,0,13,0,France,187,0.9569870161349094,0.6666169994367003,1,3,0
5,8,0,0,1,0.0,0,0,13,0,Spain,625,1.2296015562652727,0.131225121925935,1,3,0
8,8,0,0,1,0.0,0,3,16,0,US,31,0.763686819320553,-0.22023077045701905,1,3,0
11,8,6,19,2,100.0,1,2,19,7,US,371,-1.271215528571432,0.1590870677306982,0,0,1
6,8,0,2,1,0.0,0,0,14,0,US,94,0.9140510946880718,0.5199980598999286,1,3,0
10,8,0,4,1,0.0,0,0,18,0,Italy,621,0.7295735606713425,0.6998380659307187,1,3,0
6,8,15,2,1,0.0,15,1,14,30,Islande,11,-0.5205210876569187,-1.4493747679199187,3,0,2
5,9,32,2,2,100.0,2,5,14,34,Germany,424,-1.2689993689182961,-0.33292562625049543,0,0,1
14,10,41,1,2,100.0,0,0,24,41,Italy,469,-0.9926690979307358,0.9004064095671255,0,0,1
14,12,10,2,2,100.0,0,0,26,10,Italy,26,-0.997643312343275,0.9942276022934845,0,0,1
11,8,48,2,4,100.0,4,11,19,52,Netherlands,14,-1.3932203286557894,-0.06064094309441598,0,0,1
5,8,0,2,2,0.0,0,0,13,0,France,15,0.7157458596843392,0.9851192897410781,1,3,0
8,8,6,1,5,100.0,0,0,16,6,Netherlands,13,-0.5507347284054467,1.014807457455294,2,0,1
4,8,0,1,1,0.0,0,1,12,0,France,348,0.8463539708129616,-0.16142590298944817,1,3,0
7,9,141,2,5,100.0,171,9,16,312,Austria,11,-1.6046279467105788,-0.4077388509627085,0,0,1
24,8,0,27,13,69.0,0,0,32,0,France,11,-0.027290837249531397,1.9953110794340916,2,3,0
5,9,0,8,3,100.0,0,0,14,0,Spain,32,0.13233226886217112,1.736858330946347,2,3,0
7,8,38,3,4,0.0,14,0,15,52,France,40,-0.6542371440145889,-0.3499333495137796,0,0,1
3,8,0,0,1,0.0,0,0,11,0,Netherlands,68,1.8211872325051175,-0.5087243978983353,1,3,3
5,8,86,0,1,0.0,4,2,13,90,UK,14,-0.26523882448181696,-1.9118970888860618,3,0,2
6,8,0,1,1,0.0,0,0,14,0,US,251,0.9273691142100404,0.502414742929988,1,3,0
5,8,3,0,1,0.0,0,1,13,3,US,561,0.2410914498422401,-1.2231668631609651,3,0,2
8,12,30,1,2,0.0,2,0,20,32,UK,13,-0.9393633098123909,-0.3710858178823341,0,0,2
4,8,0,0,1,0.0,0,0,12,0,France,590,1.3419139293825877,0.02525760718026462,1,3,0
4,8,3,0,1,0.0,0,0,12,3,France,400,0.6210406446005802,-0.8415318944024861,3,0,2
12,9,14,13,7,85.0,0,0,21,14,Italy,15,-0.8039373973530909,0.7876116608842009,2,0,1
19,12,4,12,13,92.3,2,1,31,6,France,12,-1.5878501802758698,0.002396348666675204,0,0,1
6,8,0,0,1,0.0,0,0,14,0,Estonie,384,1.1552922511386414,0.2014957695955512,1,3,0
23,8,1,15,22,95.0,0,0,31,1,Spain,12,-0.7019162944774184,1.2063405080866776,2,0,1
9,8,0,1,1,0.0,0,0,17,0,France,325,0.7872131388315355,0.6345521073599663,1,3,0
6,8,0,0,3,66.0,0,0,14,0,France,274,0.6992317210072565,1.14471861942944,2,3,0
5,9,109,3,1,0.0,8,8,14,117,Germany,14,-0.7813107060480793,-1.693846423841917,3,0,2
10,24,342,7,3,66.0,425,10,34,767,Italy,11,-1.9415396814376107,-0.7079921571585338,0,0,1
8,8,0,0,1,0.0,0,0,16,0,Italy,688,1.049729557348179,0.3009051053742676,1,3,0
4,8,4,1,1,0.0,0,0,12,4,Germany,44,0.38084687110453747,-0.5553383223702681,3,0,2
4,9,0,0,2,0.0,0,0,13,0,France,647,0.8242630987750195,0.5476229316036951,1,3,0
6,9,2,3,1,0.0,2,1,15,4,Netherlands,19,-0.6155345753412202,-1.3270859327955833,3,0,2
3,8,59,0,1,0.0,29,0,11,88,UK,12,0.5833956798629205,-2.0777221695683648,3,0,3
7,8,0,2,9,90.0,0,0,15,0,UK,94,0.3530212663124072,1.6113052832883694,2,3,0
4,8,4,8,2,50.0,4,0,12,8,UK,35,-0.4533458108904275,-0.08761433143399708,0,0,1
9,8,0,0,3,100.0,0,0,17,0,US,610,0.4091735929336064,1.6137358429708875,2,3,0
4,8,0,0,1,0.0,0,0,12,0,US,44,1.3419139293825877,0.02525760718026462,1,3,0
15,8,9,14,27,74.0,0,0,23,9,Slovaquie,15,-0.6963403023640682,0.9999421887332275,2,0,1
4,8,1,0,1,0.0,1,0,12,2,France,16,0.3354088863754919,-1.2538477818091853,3,0,2
19,8,0,1,19,50.0,0,0,27,0,Belgium,462,0.09625743236110133,1.8546394766335397,2,3,0
4,8,0,0,1,0.0,0,2,12,0,France,11,1.0628997339020334,-0.48307309939085386,1,3,0
4,8,0,0,1,0.0,0,0,12,0,Belgium,205,1.3419139293825877,0.02525760718026462,1,3,0
22,14,185,0,5,100.0,37,53,36,222,Luxembourg,12,-1.7861687359476184,-0.5241766747542037,0,0,1
3,8,0,0,1,0.0,0,0,11,0,France,519,1.8211872325051175,-0.5087243978983353,1,3,3
60,9,41,244,70,88.0,37,14,69,78,France,11,-2.1384888973373584,0.2806571452380763,0,0,1
4,8,3,4,4,80.0,0,0,12,3,Germany,61,-0.10720817193710397,0.4721604002449196,2,0,1
4,8,0,2,1,0.0,0,0,12,0,France,406,1.1006727729320176,0.3437598974846426,1,3,0
10,8,0,0,3,100.0,0,0,18,0,France,13,0.38079139801822315,1.6403942982213509,2,3,0
14,8,0,0,1,0.0,0,0,22,0,France,691,0.8998684948968767,0.44224242958074605,1,3,0
13,8,0,1,6,100.0,0,0,21,0,Italy,11,0.05970345874036381,2.0516786053225666,2,3,0
6,8,11,0,3,66.0,1,0,14,12,France,48,-0.3928246480536394,-0.2367814124867025,3,0,1
3,8,0,0,1,0.0,0,0,11,0,Germany,385,1.8211872325051175,-0.5087243978983353,1,3,3
6,8,4,5,7,85.0,0,0,14,4,France,14,-0.3307980759111122,0.6797267906240148,2,0,1
5,15,420,0,1,0.0,5,0,20,425,France,11,-0.5730812388691744,-1.4801328530653783,3,0,2
4,8,0,0,1,0.0,0,0,12,0,France,68,1.3419139293825877,0.02525760718026462,1,3,0
9,17,3,3,8,100.0,0,0,26,3,Italy,12,-1.0125768233996113,1.0928740239535446,0,0,1
5,5,15,1,1,0.0,0,5,10,15,Romania,40,0.5922228760826584,-1.249065322275349,3,0,2
42,8,0,5,29,86.0,0,0,50,0,UK,15,-0.13987733388761003,2.121066263012391,2,3,0
5,8,0,2,1,0.0,0,0,13,0,France,691,0.9883603998147029,0.44972741223031226,1,3,0
7,8,0,2,2,0.0,46,0,15,46,France,595,-0.22556386802193096,0.04561658611051419,3,0,1
14,12,19,1,3,100.0,9,0,26,28,France,219,-1.3890734228414467,0.4634660383920671,0,0,1
7,8,4,6,8,100.0,0,0,15,4,Italy,13,-0.5401121591919674,1.0673839722996206,2,0,1
21,9,0,0,13,100.0,9,3,30,9,Germany,390,-1.0358952508761574,0.3246729534156255,0,0,1
3,8,19,0,1,0.0,0,0,11,19,Italy,52,1.0228553556892876,-1.4686481914360279,3,0,3
30,60,1209,0,3,100.0,919,9,90,2128,Singapour,11,-2.1978476146754256,-0.6680455513073298,0,0,1
3,8,1,0,1,0.0,0,0,11,1,France,701,1.145105719966689,-1.3217155607992064,3,0,3
4,8,0,0,1,0.0,0,0,12,0,France,259,1.3419139293825877,0.02525760718026462,1,3,0
4,8,3,0,1,0.0,0,1,12,3,Germany,324,0.35340382295955514,-1.3291343779066358,3,0,2
7,8,0,1,1,0.0,0,0,15,0,Spain,641,0.8676255048808447,0.5586329744394568,1,3,0
6,8,21,3,1,0.0,5,0,14,26,Germany,165,-0.24456082633598966,-0.9252009239791819,3,0,2
15,10,136,9,4,50.0,13,5,25,149,UK,22,-1.6449501951225676,-0.4442330416811921,0,0,1
12,9,0,0,5,60.0,0,0,21,0,UK,426,0.2848105937848779,1.3137642180501752,2,3,0
7,8,2,11,13,84.0,0,0,15,2,Italy,11,-0.4020269417126017,0.8360157384418588,2,0,1
59,108,1,2,7,71.0,0,0,167,1,Italy,11,-1.3284189912334052,1.132995580556949,0,0,1
10,8,226,1,3,100.0,185,25,18,411,France,11,-1.5283851760200524,-0.3707017400479209,0,0,1
5,8,2,1,4,75.0,0,0,13,2,Spain,29,-0.1720158758465493,0.5541689316812659,2,0,1
4,8,0,0,1,0.0,0,0,12,0,France,617,1.3419139293825877,0.02525760718026462,1,3,0
14,10,25,1,2,0.0,47,1,24,72,Lituanie,471,-1.321234011535132,-0.839051436276232,0,0,1
8,11,40,0,1,0.0,58,3,19,98,France,53,-0.7819264929653837,-1.8560033484499887,3,0,2
5,8,0,0,2,50.0,29,0,13,29,Italy,280,0.004106656813506773,-0.0067165745301735755,2,0,1
10,8,0,1,4,75.0,0,0,18,0,Italy,204,0.2898635814364729,1.6306348852922057,2,3,0
6,8,0,0,1,0.0,0,0,14,0,France,41,1.1552922511386414,0.2014957695955512,1,3,0
12,8,1,0,11,75.0,0,0,20,1,Italy,194,-0.24058067942449893,0.626659405781977,2,0,1
15,8,1,17,26,88.0,0,0,23,1,Spain,20,-0.6152303124529324,1.1251826490611372,2,0,1
6,10,0,0,1,0.0,0,0,16,0,France,687,0.8663048247468625,0.16212463623431964,1,3,0
4,8,1,0,3,0.0,0,0,12,1,Canada,17,0.377576522576609,-0.22162338286757866,3,0,2
4,8,4,0,1,0.0,0,1,12,4,Germany,525,0.3411331863921141,-1.3438597792088551,3,0,2
6,8,0,0,1,0.0,0,1,14,0,Italy,57,0.887655429497617,-0.2861067139085986,1,3,0
12,8,3,15,19,94.0,0,0,20,3,Italy,11,-0.6010420849400239,1.0108251381546143,2,0,1
7,8,0,0,1,0.0,0,0,15,0,Italy,673,1.0955486418094456,0.25771400110501996,1,3,0
8,9,1,2,4,100.0,0,0,17,1,France,18,-0.673495362804477,1.0474608120340505,2,0,1
8,8,0,0,1,0.0,0,1,16,0,Spain,442,0.7820927357071539,-0.1866973781298822,1,3,0
5,8,9,0,1,0.0,0,0,13,9,France,231,0.463676404148175,-0.789688828729227,3,0,2
6,8,0,0,2,0.0,0,0,14,0,France,397,0.8826777110082783,0.7368876471063167,1,3,0
10,9,2,1,7,100.0,24,4,19,26,France,12,-1.4797148352446239,-0.03825014498660492,0,0,1
20,8,106,1,4,75.0,0,2,28,106,Germany,44,-1.037615251773258,0.20571765812248577,0,0,1
8,8,25,0,1,0.0,4,3,16,29,Croatie,29,-0.38927743382887614,-1.6795920490827674,3,0,2
30,37,27,1,5,100.0,3,2,67,30,Spain,218,-2.0081262130432243,0.16204782183305858,0,0,1
12,8,15,1,1,0.0,69,2,20,84,France,224,-0.7871178345665435,-1.3469996422181518,3,0,2
6,8,0,0,3,100.0,0,0,14,0,US,183,0.5493295683121115,1.4815984785409098,2,3,0
10,18,5,0,1,0.0,3,2,28,8,Germany,38,-0.7974918102170153,-1.5742548426037235,3,0,2
10,16,2,1,2,100.0,1,0,26,3,Germany,28,-1.2532489008680372,0.5479084091493861,0,0,1
3,8,117,1,1,0.0,2,0,11,119,Italy,12,0.373543050642414,-1.7448811561301074,3,0,3
15,9,3,11,12,91.0,5,0,24,8,Italy,20,-1.1683289949368232,0.4419826522410115,0,0,1
4,8,1,0,1,0.0,10,1,12,11,US,392,-0.001909672258987781,-1.8340146820056107,3,0,2
8,9,2,14,11,100.0,0,0,17,2,Italy,11,-0.7794661484457157,1.135645911077403,2,0,1
8,8,0,0,5,80.0,0,0,16,0,France,212,0.5713169458780516,1.2894745364716402,2,3,0
23,8,165,4,21,80.0,0,1,31,165,France,13,-1.1682676179482987,0.370131124458943,0,0,1
4,8,0,0,2,100.0,1,0,12,1,Netherlands,631,0.09020497598274414,0.4000140885484779,2,0,1
22,20,20,5,6,100.0,0,0,42,20,US,12,-1.277380520263783,1.1527208872407027,0,0,1
5,8,3,10,7,100.0,0,0,13,3,Italy,14,-0.402684240781947,0.9650403138071146,2,0,1
24,23,34,46,34,85.0,9,1,47,43,Italy,11,-1.9312585701678113,0.0012332047613314583,0,0,1
3,8,0,0,1,0.0,0,0,11,0,France,313,1.8211872325051175,-0.5087243978983353,1,3,3
4,10,126,4,2,100.0,32,2,14,158,Italy,11,-1.409063124007099,-0.5061122290119424,0,0,1
7,8,0,9,4,66.6,0,0,15,0,Italy,12,0.35194209920903236,1.5881589877053055,2,3,0
12,7,30,1,1,0.0,0,1,19,30,Italy,34,-0.09622021953225418,-0.6533917321975419,3,0,2
4,8,1,0,1,0.0,1,0,12,2,UK,200,0.3354088863754919,-1.2538477818091853,3,0,2
3,8,1,0,1,0.0,1,0,11,2,UK,293,0.8146821894980212,-1.7878297868877844,3,0,3
4,9,16,0,1,0.0,15,1,13,31,France,37,-0.3401798584584078,-1.960096313413791,3,0,2
3,0,0,0,1,0.0,0,0,3,0,France,44,3.2755774739096957,-0.7662209916491937,1,1,2
4,8,4,0,1,0.0,0,0,12,4,Portugal,14,0.6087700080331391,-0.8562572957047052,3,0,2
3,8,0,0,1,0.0,0,0,11,0,Italy,664,1.8211872325051175,-0.5087243978983353,1,3,3
18,9,19,84,29,66.0,15,0,27,34,Italy,11,-1.3598143658756232,0.4491933668009828,0,0,1
4,8,0,0,2,100.0,0,0,12,0,France,376,0.751592600693245,1.2746420207833602,2,3,0
13,8,1,4,4,75.0,0,0,21,1,UK,14,-0.48654520533122825,0.9232440240935531,2,0,1
12,5,1,4,6,33.0,12,1,17,13,France,11,-0.8104315435784587,-0.06305401893966191,0,0,1
3,9,2,0,1,0.0,0,1,12,2,UK,11,0.5520743743033355,-1.813999036030619,3,0,3
4,8,7,0,1,0.0,0,0,12,7,UK,442,0.5861579829519228,-0.8834366438501331,3,0,2
5,7,4,7,7,100.0,2,1,12,6,France,50,-0.6619208413875671,0.03938346978348,0,0,2
7,8,1,7,7,71.0,0,0,15,1,France,20,-0.3352934160859124,0.8011847549738265,2,0,1
8,8,6,0,1,0.0,4,2,16,10,Australia,68,-0.32592868233536776,-1.5992276129457568,3,0,2
130,12,1,47,123,91.0,0,0,142,1,Germany,11,-1.3778143092097455,1.5562157964561674,0,0,1
3,2,32,0,1,0.0,11,0,5,43,France,25,1.2169272490933243,-2.090895032014127,3,0,3
8,8,36,3,2,0.0,0,0,16,36,France,475,-0.304197481132236,0.16640709057448128,2,0,1
5,8,0,0,1,0.0,0,0,13,0,UK,418,1.2296015562652727,0.131225121925935,1,3,0
8,8,0,0,1,0.0,0,0,16,0,Belgium,441,1.049729557348179,0.3009051053742676,1,3,0
10,8,0,11,9,88.0,0,0,18,0,Bulgaria,35,0.2054581849287091,1.7639432578951855,2,3,0
3,8,0,1,2,0.0,12,0,11,12,Hong Kong,11,0.5687365297607122,-0.6661898381152701,3,0,3
12,8,1,8,10,90.0,3,0,20,4,Chypre,12,-0.8784691234876549,0.49224347653329054,0,0,1
4,8,58,2,1,0.0,11,9,12,69,Italy,11,-0.4184974503153528,-1.7494519165359723,3,0,2
4,9,0,0,1,0.0,0,0,13,0,France,331,1.0968776389053831,0.01223105409292955,1,3,0
4,8,0,0,1,0.0,0,0,12,0,France,407,1.3419139293825877,0.02525760718026462,1,3,0
3,8,0,0,1,0.0,0,0,11,0,France,621,1.8211872325051175,-0.5087243978983353,1,3,3
18,10,75,9,7,100.0,49,3,28,124,Italy,11,-1.8398086394177309,-0.01949398321420763,0,0,1
6,8,1,2,3,100.0,3,0,14,4,Germany,22,-0.7282278166203319,0.48122021939813386,0,0,1
6,8,1,5,4,100.0,0,0,14,1,Italy,16,-0.3988638702880299,1.034236252353509,2,0,1
5,8,0,0,1,0.0,0,0,13,0,Spain,531,1.2296015562652727,0.131225121925935,1,3,0
6,8,2,3,2,100.0,0,0,14,2,France,322,-0.3896071550294729,0.9333504547225939,2,0,1
5,8,43,4,2,100.0,0,1,13,43,Germany,14,-0.7269079640797559,0.2208881169329827,0,0,1
8,8,11,2,7,100.0,0,0,16,11,Italy,15,-0.5977451980020393,1.0220330051562658,2,0,1
24,17,111,4,12,90.9,27,0,41,138,Italy,12,-1.6117948767428467,0.25071645056552516,0,0,1
21,9,7,0,5,80.0,12,4,30,19,Swiss,12,-1.2608020287377577,-0.5365404876650388,0,0,1
7,8,1,0,3,0.0,0,0,15,1,Spain,88,0.13121123500346715,0.010833011057176605,3,0,2
5,8,0,0,1,0.0,0,0,13,0,Denmark,284,1.2296015562652727,0.131225121925935,1,3,0
3,8,5,0,1,0.0,2,0,11,7,Spain,359,0.7457104678008639,-1.8726502427141283,3,0,3
11,8,1,10,9,100.0,0,0,19,1,France,15,-0.6353736694512122,1.2882085408370176,2,0,1
9,8,0,0,1,0.0,0,0,17,0,Spain,699,1.0151362757601365,0.3336331340255292,1,3,0
8,8,1,12,3,100.0,0,0,16,1,Italy,11,-0.5156714132405608,1.1421227252326123,2,0,1
11,8,0,0,1,0.0,0,0,19,0,France,670,0.9598311910461216,0.3854515817640569,1,3,0
11,11,110,3,2,50.0,5,0,22,115,UK,139,-1.240717481377277,-0.014008213721848493,0,0,1
3,9,0,1,1,0.0,0,0,12,0,France,241,1.2965149917193006,-0.1780780929311503,1,3,3
7,8,0,1,1,0.0,0,0,15,0,Italy,56,0.8676255048808447,0.5586329744394568,1,3,0
12,8,1,2,3,66.0,0,0,20,1,Italy,15,-0.43706006478811316,0.856399820366607,2,0,1
4,8,118,11,2,100.0,0,0,12,118,Spain,13,-0.4228465593920368,0.572031806661389,2,0,1
36,12,35,60,62,87.0,2,2,48,37,France,12,-1.899475218245172,0.1288404886129822,0,0,1
15,16,253,1,5,80.0,432,6,31,685,Sweden,15,-1.87061263742642,-0.6510583018417513,0,0,1
20,8,0,0,1,0.0,0,0,28,0,Swiss,652,0.8261692431966422,0.5112159095950015,1,3,0
7,10,1,11,4,75.0,7,0,17,8,Spain,12,-0.9894182755745679,0.1882607160630648,0,0,1
5,8,0,0,1,0.0,0,0,13,0,Germany,206,1.2296015562652727,0.131225121925935,1,3,0
4,8,0,0,1,0.0,0,0,12,0,Netherlands,660,1.3419139293825877,0.02525760718026462,1,3,0
5,9,7,0,2,100.0,2,3,14,9,France,70,-0.9520283176093851,-0.5542374111208881,0,0,1
11,8,0,3,5,83.0,0,0,19,0,France,37,0.23027484356009292,1.7067956519119154,2,3,0
4,8,3,5,2,0.0,0,0,12,3,US,14,0.08620937511829124,0.040055591202306506,3,0,1
5,8,0,0,1,0.0,0,0,13,0,France,698,1.2296015562652727,0.131225121925935,1,3,0
7,8,2,4,5,0.0,0,0,15,2,France,48,-0.17185421715070073,0.3498281060760292,2,0,1
147,10,77,26,174,74.0,104,1,157,181,UK,11,-2.330461437908712,0.49670331951602553,0,0,1
5,8,0,0,1,0.0,0,0,13,0,France,423,1.2296015562652727,0.131225121925935,1,3,0
6,8,2,2,5,40.0,170,4,14,172,UK,12,-1.0575153321473363,-0.592194869088438,0,0,1
10,8,14,1,7,85.0,6,0,18,20,France,118,-0.8687416390047243,0.23337679361554373,0,0,1
4,8,1,1,2,0.0,0,0,12,1,France,73,0.16529473978519507,0.048577295124596,3,0,1
9,8,0,0,6,100.0,0,0,17,0,Italy,97,0.38707868156881226,1.6571283783557371,2,3,0
4,8,0,0,1,0.0,0,3,12,0,France,493,1.0558711913549614,-0.49587826865102175,1,3,0
13,12,7,10,16,87.0,0,0,25,7,Italy,11,-0.9377697391065453,0.8683243950589433,0,0,1
4,8,5,0,1,0.0,13,1,12,18,France,80,-0.05339630603874083,-1.8964972806072873,3,0,2
4,8,0,1,2,0.0,0,0,12,0,Italy,599,0.8413762523236232,0.8615684580254667,1,3,0
28,9,11,7,13,84.0,1,0,37,12,France,13,-1.300174576762791,0.5429826633544006,0,0,1
9,8,1,0,2,100.0,0,1,17,1,Italy,17,-0.5189033871086591,0.28242390122360456,2,0,1
10,10,29,0,3,100.0,9,4,20,38,Spain,11,-1.338072179571076,-0.4535110692866451,0,0,1
9,8,0,0,1,0.0,0,0,17,0,UK,644,1.0151362757601365,0.3336331340255292,1,3,0
4,8,1,1,2,100.0,0,3,12,1,Germany,16,-0.43845478680141065,0.24143395538564022,2,0,1
7,8,0,0,1,0.0,0,0,15,0,Italy,659,1.0955486418094456,0.25771400110501996,1,3,0
6,8,0,0,2,100.0,4,1,14,4,UK,104,-0.4127611989496491,0.024654825037056682,0,0,1
16,17,14,24,33,87.0,0,0,33,14,Italy,13,-1.127216797023482,0.9538572057569451,0,0,1
6,8,0,0,1,0.0,29,3,14,29,France,574,0.08046633206628509,-1.3617544702347548,3,0,2
3,8,72,0,1,0.0,0,0,11,72,UK,94,0.9541263986095359,-1.5512314771427431,3,0,3
3,8,2,2,2,0.0,0,0,11,2,Portugal,13,0.6026046032206418,-0.5022297163440737,3,0,3
5,8,0,0,4,100.0,0,0,13,0,Germany,621,0.6137436767289541,1.430761159490737,2,3,0
18,8,1,4,3,100.0,0,0,26,1,US,201,-0.6925396126982941,1.2989012910897744,2,0,1
18,9,4,7,33,93.0,2,0,27,6,France,16,-1.2118212565987572,0.5472356204350188,0,0,1
8,8,2,0,8,100.0,2,0,16,4,France,37,-0.6315762014181519,0.31315473110423564,0,0,1
12,9,11,2,12,58.0,0,0,21,11,Spain,93,-0.7576039888574994,0.7564462549436878,2,0,1
8,8,0,1,1,0.0,4,0,16,4,US,542,0.11171112066165477,-0.3367987959487362,3,0,1
21,8,12,7,44,93.0,9,3,29,21,Italy,11,-1.435669287613869,0.046282890500862865,0,0,1
7,8,0,0,2,100.0,0,0,15,0,Spain,488,0.505227313120103,1.5070984147081166,2,3,0
12,8,0,0,1,0.0,0,0,20,0,Spain,670,0.9363231343322702,0.40766584312921145,1,3,0
5,8,15,0,1,0.0,18,1,13,33,Netherlands,606,-0.21080446693739407,-1.845961300081475,3,0,2
12,9,19,0,7,100.0,2,16,21,21,Belgium,13,-1.322001270586831,-0.33187738125899363,0,0,1
4,8,0,0,2,100.0,0,0,12,0,France,383,0.751592600693245,1.2746420207833602,2,3,0
6,8,40,1,4,75.0,52,1,14,92,France,59,-1.0470481240109286,-0.586904546319418,0,0,1
28,52,35,21,10,90.0,1,0,80,36,Italy,11,-1.7033081416224487,0.4943320177972231,0,0,1
4,10,11,0,1,0.0,0,0,14,11,France,13,0.2231832660912427,-0.8976601361712346,3,0,2
14,8,7,5,14,100.0,0,5,22,7,UK,79,-1.0709419492739154,0.7203162184199834,0,0,1
3,8,0,0,1,0.0,0,0,11,0,Belgium,19,1.8211872325051175,-0.5087243978983353,1,3,3
3,8,10,1,1,0.0,0,1,11,10,Belgium,120,0.5564193887510576,-1.6202596877682072,3,0,3
12,8,0,8,16,87.0,0,0,20,0,Spain,22,0.14318113520561057,1.8394271558315807,2,3,0
14,9,5,2,7,85.0,0,0,23,5,Italy,13,-0.7507681709125192,0.812651599324177,2,0,1
7,8,0,0,1,0.0,1,0,15,1,US,359,0.4341610170989455,-0.6169139311298631,3,0,1
8,10,0,0,1,0.0,349,1,18,349,Germany,11,-0.3805372412345925,-1.4439027974512133,3,0,2
15,8,0,2,6,50.0,0,0,23,0,Belgium,312,0.16890119155026093,1.7534268364611425,2,3,0
3,9,3,0,1,0.0,0,0,12,3,France,293,0.8035648438658942,-1.3457865678483376,3,0,3
4,8,32,0,1,0.0,0,1,12,32,Denmark,18,0.24977619604188384,-1.4537314317868697,3,0,2
4,8,4,0,1,0.0,9,3,12,13,Italy,18,-0.05166726962882961,-1.904006335373819,3,0,2
9,9,0,0,1,0.0,2,2,18,2,Belgium,32,-0.13570918367643797,-1.1428062578471565,3,0,2
35,89,35,2,15,60.0,2,0,124,37,France,385,-1.748705251005095,0.44829192279754065,0,0,1
15,10,10,49,13,92.0,0,0,25,10,Italy,11,-0.9496953259756308,0.9284440122036196,0,0,1
5,8,34,0,2,0.0,0,0,13,34,France,348,0.12879146905552719,-0.3292222133145396,3,0,2
7,11,59,1,2,100.0,10,4,18,69,Netherlands,13,-1.5428640960467774,-0.3054405274006869,0,0,1
5,8,3,0,1,0.0,3,0,13,6,UK,346,0.16230500543534646,-1.2244060964339634,3,0,2
7,8,2,3,4,100.0,4,0,15,6,UK,13,-0.834011805318074,0.5343057161079537,0,0,1
6,8,1,0,1,0.0,0,0,14,1,Spain,353,0.479210738600214,-0.6114953933053203,3,0,2
4,8,0,2,2,0.0,0,0,12,0,Italy,14,0.8280582328016545,0.8791517749954078,1,3,0
10,8,0,9,12,100.0,0,0,18,0,UK,12,0.05913755897787823,2.0942295369814365,2,3,0
3,8,0,0,1,0.0,0,1,11,0,UK,87,1.5535504108640927,-0.9963268814024853,1,3,3
3,8,0,0,1,0.0,0,0,11,0,France,612,1.8211872325051175,-0.5087243978983353,1,3,3
23,12,79,1,23,95.0,12,0,35,91,Italy,13,-1.4869914018520232,0.2853375925629883,0,0,1
4,8,0,0,2,100.0,0,0,12,0,UK,275,0.751592600693245,1.2746420207833602,2,3,0
7,9,18,0,1,0.0,0,0,16,18,US,419,0.10135237706242813,-0.7509694477324665,3,0,2
3,8,0,0,1,0.0,0,0,11,0,France,675,1.8211872325051175,-0.5087243978983353,1,3,3
4,12,81,0,3,66.0,11,4,16,92,Italy,97,-1.1012414620166557,-1.071203013137073,0,0,1
10,11,21,3,2,0.0,2,0,21,23,US,103,-0.9599292411289883,-0.2796743436126026,0,0,2
3,8,0,0,3,100.0,0,0,11,0,France,503,1.215224549678587,0.7713783110470233,1,3,3
18,11,41,7,11,100.0,2,2,29,43,Germany,11,-1.7798130996721881,0.13423299380476744,0,0,1
5,8,0,0,1,0.0,0,0,13,0,US,616,1.2296015562652727,0.131225121925935,1,3,0
17,12,65,0,2,100.0,7,7,29,72,UK,67,-1.5329995175281277,-0.4460691539559164,0,0,1
9,8,13,0,1,0.0,1,0,17,14,Germany,642,-0.08379374455723751,-1.056112871406298,3,0,2
7,8,2,0,1,0.0,0,0,15,2,US,28,0.39082170910590447,-0.5896854851558619,3,0,2
4,8,6,2,4,50.0,0,0,12,6,UK,16,-0.11091445050484419,0.39710791706635307,2,0,1
127,40,863,40,87,89.0,68,0,167,931,Italy,11,-2.2125490544482322,0.5190233396294773,0,0,1
8,8,1,0,4,50.0,0,0,16,1,US,151,-0.08860022444426002,0.44223823397801393,2,0,1
6,8,20,0,1,0.0,17,2,14,37,Italy,371,-0.30537458204159174,-1.8067881684436191,3,0,2
13,13,4,0,2,0.0,0,0,26,4,France,675,-0.4119098067283789,-0.007475055390660718,3,0,1
8,8,5,0,2,0.0,3,0,16,8,France,622,-0.30748870869477396,-0.5399923398668856,3,0,2
4,8,2,0,1,0.0,0,0,12,2,UK,567,0.6371869966790464,-0.8221418790806172,3,0,2
21,8,1,19,11,63.0,0,0,29,1,Italy,30,-0.6494983511624871,1.1169429720827437,2,0,1
4,8,0,0,1,0.0,0,0,12,0,Italy,38,1.3419139293825877,0.02525760718026462,1,3,0
3,10,79,0,1,0.0,1,0,13,80,France,51,0.20852425069211786,-1.9338115732696524,3,0,3
6,8,2,1,2,50.0,0,0,14,2,France,170,-0.21406953690053665,0.5591879242120175,2,0,1
4,8,20,1,2,50.0,1,0,12,21,Ireland,14,-0.44191725651529723,-0.18378524142221522,3,0,1
4,8,0,1,2,100.0,0,0,12,0,Italy,13,0.5236694637646434,1.5755609941177975,2,3,0
5,9,1,0,2,0.0,0,0,14,1,Italy,410,0.06305198085212481,-0.18187423601529562,3,0,2
4,8,1,1,5,100.0,0,0,12,1,France,11,-0.18529291472661488,0.8271450682833266,2,0,1
4,8,1,1,1,0.0,9,0,12,10,US,420,0.04211039434880828,-1.039847435962595,3,0,2
14,8,3,2,6,50.0,2,0,22,5,Netherlands,22,-0.8735449868786764,0.3963100539476428,0,0,1
5,11,0,0,2,0.0,13,1,16,13,France,135,-0.4335307818746102,-0.8279643041615636,0,0,2
10,10,339,0,9,88.0,31,14,20,370,Australia,40,-1.408297040682973,-0.931994413826185,0,0,1
5,8,0,0,1,0.0,0,0,13,0,Netherlands,699,1.2296015562652727,0.131225121925935,1,3,0
3,8,0,0,1,0.0,0,0,11,0,France,610,1.8211872325051175,-0.5087243978983353,1,3,3
25,10,0,1,26,100.0,0,0,35,0,Italy,40,-0.3549389855886906,2.1848150624643465,2,3,0
3,8,0,1,1,0.0,0,1,11,0,UK,58,1.325627273935491,-0.6954079080680482,1,3,3
7,10,118,0,1,0.0,7,0,17,125,Austria,14,-0.41694067092906345,-1.3646987973652553,3,0,2
46,19,1308,63,87,92.0,564,36,65,1872,Spain,11,-2.4233778598276814,-0.3052569577811178,0,0,1
6,8,14,0,2,100.0,1,3,14,15,France,11,-0.823729329166364,-0.46447995595665376,0,0,1
3,8,0,4,2,0.0,0,0,11,0,France,12,1.2913921722013426,0.36621395626715647,1,3,3
10,8,4,0,10,70.0,0,0,18,4,France,180,-0.2422780578933912,0.5006755280856999,2,0,1
4,8,0,0,4,75.0,0,0,12,0,Italy,105,0.8729465669029091,0.9946819298620403,1,3,0
4,8,0,0,1,0.0,0,0,12,0,France,645,1.3419139293825877,0.02525760718026462,1,3,0
13,8,0,1,8,87.0,0,0,21,0,UK,29,0.19233656335690372,1.7512608192320753,2,3,0
7,8,3,0,1,0.0,0,0,15,3,Netherlands,60,0.3746753570274382,-0.6090755004777303,3,0,2
41,85,69,12,17,58.0,0,0,126,69,Italy,14,-1.507902266919494,0.9500370152188016,0,0,1
4,8,0,2,3,100.0,0,0,12,0,UK,390,0.49471009010548733,1.6238626064300008,2,3,0
51,9,66,13,65,90.0,1,0,60,67,Spain,11,-1.581436277445156,0.6854517923587762,0,0,1
6,8,0,2,4,50.0,0,0,14,0,France,18,0.45180282543406064,1.4743223514045463,2,3,0
6,8,0,2,4,50.0,0,0,14,0,Belgium,57,0.45180282543406064,1.4743223514045463,2,3,0
8,8,0,4,7,85.0,0,0,16,0,France,88,0.3018193608263881,1.6540018978484006,2,3,0
205,2013,35,3,1,0.0,4,0,2218,39,France,45,-1.8281577877368487,-0.15441415184957882,0,0,1
8,8,0,0,1,0.0,0,0,16,0,France,686,1.049729557348179,0.3009051053742676,1,3,0
9,8,0,0,1,0.0,0,0,17,0,France,693,1.0151362757601365,0.3336331340255292,1,3,0
27,17,699,8,14,64.0,2,28,44,701,Netherlands,11,-2.0265327310642443,-0.38838042794045924,0,0,1
4,8,1,0,3,66.0,0,0,12,1,France,254,0.20977188671277455,0.15548929411328272,2,0,1
11,13,3,1,2,0.0,0,0,24,3,Italy,37,-0.5975978248071929,0.2780819975910985,0,0,1
21,9,12,7,10,80.0,0,0,30,12,Italy,15,-0.9035659191088414,0.8992323662476608,2,0,1
7,8,0,6,2,0.0,0,1,15,0,Lituanie,221,0.28911982463813907,0.6569282117541319,2,3,0
8,8,0,3,1,0.0,0,0,16,0,France,11,0.7998784125729491,0.6307748631590961,1,3,0
18,15,10,0,1,0.0,66,0,33,76,Italy,139,-0.6947974560827817,-1.131220488970922,3,0,2
16,15,1,4,18,44.0,3,0,31,4,Italy,30,-1.2725681860633036,0.44532964697697086,0,0,1
4,8,0,0,1,0.0,0,0,12,0,Spain,386,1.3419139293825877,0.02525760718026462,1,3,0
8,0,1,1,2,100.0,0,0,8,1,France,17,0.8334427501500073,0.926520061655399,2,1,2
6,9,2,1,1,0.0,2,1,15,4,France,357,-0.5936065674945915,-1.3560367172459746,3,0,2
4,8,0,0,2,100.0,0,0,12,0,France,597,0.751592600693245,1.2746420207833602,2,3,0
5,8,0,0,2,0.0,0,0,13,0,Spain,581,0.9569870161349094,0.6666169994367003,1,3,0
4,8,0,0,1,0.0,0,0,12,0,US,507,1.3419139293825877,0.02525760718026462,1,3,0
5,8,0,2,2,0.0,0,0,13,0,Italy,366,0.7157458596843392,0.9851192897410781,1,3,0
4,8,0,0,2,100.0,0,0,12,0,Italy,231,0.751592600693245,1.2746420207833602,2,3,0
28,9,11,17,26,82.6,0,0,37,11,Italy,11,-1.0199454289427952,1.0567138297039358,0,0,1
10,8,0,3,15,93.0,0,1,18,0,Sweden,11,-0.05317911358520729,1.2798897128091353,2,3,0
56,8,727,4,66,83.0,16,0,64,743,France,11,-1.5873197392668466,0.499923740913595,0,0,1
4,8,2,0,1,0.0,1,0,12,3,Italy,11,0.31295873171851274,-1.2806092005130096,3,0,2
45,8,0,17,84,98.7,0,0,53,0,Italy,11,-0.22719754735992062,2.257592211386359,2,3,0
5,9,63,0,1,0.0,1,0,14,64,France,188,-0.1638948733717977,-1.3862081591167192,3,0,2
29,8,0,3,3,0.0,0,0,37,0,France,658,0.1986507815672076,1.4912513705510329,2,3,0
3,8,0,0,1,0.0,0,0,11,0,Finland,19,1.8211872325051175,-0.5087243978983353,1,3,3
3,8,4,0,1,0.0,0,0,11,4,France,138,1.0880433111556682,-1.3902393007833047,3,0,3
4,5,82,0,2,0.0,0,8,9,82,France,573,0.5038836053661597,-1.1882997325149973,3,0,2
42,9,0,0,3,0.0,0,0,51,0,US,690,0.20220661951460897,1.159541191917501,2,3,0
23,8,10,6,16,100.0,1,0,31,11,France,12,-1.2199418500820827,0.9029589636261501,0,0,1
3,8,1,1,1,0.0,0,0,11,1,Belgium,596,0.9171825830380879,-1.020796587464769,3,0,3
4,9,2,0,2,66.0,0,0,13,2,France,320,-0.04826846979235656,0.07733612232367464,2,0,1
6,8,11,1,8,87.0,0,2,14,11,UK,11,-0.6205756053314817,0.08712043358525334,0,0,1
5,8,0,1,2,100.0,0,0,13,0,Netherlands,84,0.41135709064732834,1.681528508863468,2,3,0
18,8,16,4,28,100.0,0,0,26,16,Italy,11,-0.8797776269849629,1.3016649326724088,2,0,1
8,8,0,0,1,0.0,0,0,16,0,Romania,599,1.049729557348179,0.3009051053742676,1,3,0
6,8,0,5,17,94.0,0,0,14,0,Italy,72,0.3672057178973529,1.6318900012363526,2,3,0
6,8,0,1,3,0.0,0,0,14,0,France,524,0.6391132199424895,1.068524915783016,1,3,0
58,8,2,62,50,100.0,0,0,66,2,Italy,11,-1.1343708874543053,1.7713676143292092,2,0,1
6,8,0,0,2,0.0,0,0,14,0,France,43,0.8826777110082783,0.7368876471063167,1,3,0
8,8,0,0,1,0.0,0,0,16,0,UK,551,1.049729557348179,0.3009051053742676,1,3,0
4,8,17,2,1,0.0,3,0,12,20,UK,11,-0.029956289605315302,-1.087672158649722,3,0,2
47,8,13,25,43,93.0,19,0,55,32,Italy,11,-1.391746577317572,0.7453342569861485,0,0,1
5,8,12,0,1,0.0,18,1,13,30,UK,265,-0.2032668499374222,-1.8369843216459272,3,0,2
5,10,61,0,3,66.0,13,0,15,74,France,14,-0.7560416420136384,-0.49440787293637484,0,0,1
5,8,5,1,3,66.0,0,0,13,5,Netherlands,225,-0.19634769691071294,0.4832473037535274,2,0,1
8,8,46,1,5,100.0,15,4,16,61,Denmark,11,-1.30543056517275,-0.151525172033822,0,0,1
6,8,68,3,3,66.0,10,0,14,78,Grèce,11,-0.770140949560233,-0.06791603873552342,0,0,1
4,9,118,2,1,0.0,4,3,13,122,US,14,-0.662234911858165,-1.7443966631193994,3,0,2
6,14,0,0,1,0.0,0,0,20,0,Belgium,426,0.7197626227547783,0.1974688503734848,1,3,0
4,8,0,1,1,0.0,0,0,12,0,Italy,364,1.1139907924539865,0.32617658051470155,1,3,0
4,9,2,1,1,0.0,5,0,13,7,Spain,48,-0.2015063858641497,-1.048432088104858,3,0,2
5,8,0,0,1,0.0,0,0,13,0,France,468,1.2296015562652727,0.131225121925935,1,3,0
5,8,0,1,1,0.0,0,0,13,0,France,647,1.0016784193366715,0.43214409526037173,1,3,0
4,8,13,0,3,66.0,5,2,12,18,France,11,-0.5226876523248212,-0.9718466081157913,3,0,1
40,174,13,0,5,100.0,1900,41,214,1913,Bulgaria,112,-2.342391036603462,-0.5477120429652131,0,0,1
7,8,52,2,2,50.0,61,0,15,113,Italy,15,-0.8331456728783323,-0.10665132819898222,0,0,1
18,14,83,3,14,100.0,16,0,32,99,Croatie,11,-1.6276220100323862,0.5358430723791274,0,0,1
23,8,0,0,13,100.0,0,0,31,0,US,161,0.14070378024630203,1.9157934197906312,2,3,0
4,9,5,0,1,0.0,0,1,13,5,UK,11,0.08727523114835901,-1.367491070751954,3,0,2
3,9,6,0,3,100.0,1,0,12,7,Netherlands,20,-0.15055132973320226,-0.5527336163375012,3,0,3
13,8,1,1,9,100.0,0,0,21,1,France,116,-0.6287588597138988,1.2630022970923427,2,0,1
25,12,58,4,9,80.0,11,0,37,69,Portugal,11,-1.476969460063214,0.2875134888970335,0,0,1
3,8,0,0,1,0.0,0,0,11,0,UK,330,1.8211872325051175,-0.5087243978983353,1,3,3
6,8,0,3,1,0.0,0,0,14,0,France,36,0.9054411063634118,0.5313655273803796,1,3,0
4,9,2,0,1,0.0,0,0,13,2,Australia,86,0.3921507062018414,-0.8351684321679523,3,0,2
4,8,0,0,1,0.0,0,0,12,0,US,608,1.3419139293825877,0.02525760718026462,1,3,0
3,8,0,0,1,0.0,0,0,11,0,France,692,1.8211872325051175,-0.5087243978983353,1,3,3
5,8,0,0,1,0.0,0,0,13,0,Italy,18,1.2296015562652727,0.131225121925935,1,3,0
6,8,0,0,2,0.0,0,0,14,0,US,385,0.8826777110082783,0.7368876471063167,1,3,0
23,8,0,0,2,0.0,0,0,31,0,US,642,0.5223353024076265,1.0762581187145663,1,3,0
4,8,1,0,1,0.0,0,0,12,1,US,572,0.6658324168441601,-0.7877335557206065,3,0,2
3,8,16,0,1,0.0,2,0,11,18,US,232,0.7006710777985832,-1.9266623911195582,3,0,3
3,9,1,4,3,100.0,1,1,12,2,Spain,15,-0.6128469390001604,-0.6260557531591014,0,0,3
3,8,0,0,1,0.0,0,0,11,0,France,483,1.8211872325051175,-0.5087243978983353,1,3,3
3,8,14,4,1,0.0,4,2,11,18,Italy,11,0.15688920843559942,-2.107015362734715,3,0,3
4,8,0,0,2,0.0,0,0,12,0,Italy,131,1.0692993892522245,0.5606494846910298,1,3,0
10,8,2,2,13,92.3,0,0,18,2,Italy,12,-0.4763360165056102,0.8981583387977925,2,0,1
14,9,0,1,7,100.0,0,0,23,0,UK,100,-0.13748245333963693,2.0063042783665166,2,3,0
11,8,1,3,2,0.0,0,0,19,1,US,467,-0.23871600639790008,0.4377220541587797,2,0,1
11,10,79,0,2,100.0,70,12,21,149,US,75,-1.4605350664347654,-0.6241024607715305,0,0,1
8,15,52,1,1,0.0,7,0,23,59,Denmark,22,-0.7796578062536053,-0.9530356788102173,3,0,2
6,10,10,4,3,0.0,0,0,16,10,France,14,-0.44833947487853265,0.1429295060419146,3,0,1
16,8,2,1,4,100.0,0,0,24,2,France,381,-0.6785899360494226,1.223438037592759,2,0,1
5,8,2,5,4,100.0,1,0,13,3,France,11,-0.6774282502870463,0.4710899598914901,2,0,1
3,8,0,1,1,0.0,0,0,11,0,Italy,618,1.5932640955765158,-0.20780542456389847,1,3,3
37,8,3,0,20,90.0,0,0,45,3,Italy,407,-0.5663077033800153,0.8674917492665853,2,0,1
35,9,2,185,87,94.0,2,0,44,4,Italy,11,-1.4532564314311969,0.8889049590328862,0,0,1
7,8,0,0,1,0.0,0,0,15,0,Italy,630,1.0955486418094456,0.25771400110501996,1,3,0
13,14,12,5,12,58.0,3,1,27,15,UK,11,-1.5655703389094282,-0.1856108704129136,0,0,1
3,8,1,0,4,75.0,0,0,11,1,France,634,0.6761383574870102,-0.3522912381174303,3,0,3
11,8,2,0,2,100.0,0,0,19,2,Italy,30,-0.3352170703467632,0.7874365091062716,2,0,1
3,8,14,0,1,0.0,9,1,11,23,Sweden,12,0.4060492764469002,-2.452127159508806,3,0,3
7,8,0,13,4,100.0,0,0,15,0,Italy,11,0.1947067104034667,1.9335045491198524,2,3,0
4,8,4,1,3,100.0,0,0,12,4,France,12,-0.22511581172199294,0.7247643865750902,2,0,1
7,8,0,1,2,100.0,0,0,15,0,Italy,12,0.27730417619150144,1.8080173880425532,2,3,0
14,22,46,8,8,62.0,139,3,36,185,France,107,-1.8561126062944628,-0.40489257195319567,0,0,1
5,8,1,7,9,66.0,3,0,13,4,Spain,11,-0.5674077269408975,0.17995342863865033,0,0,1
4,8,0,0,1,0.0,0,0,12,0,France,616,1.3419139293825877,0.02525760718026462,1,3,0
5,8,15,6,3,66.0,0,1,13,15,Germany,14,-0.5480368204204523,-0.008910947624300392,0,0,1
10,8,65,4,8,37.0,12,2,18,77,Belgium,11,-1.2529082439034502,-0.363611348238302,0,0,1
3,8,0,1,1,0.0,0,0,11,0,France,338,1.5932640955765158,-0.20780542456389847,1,3,3
3,8,0,0,1,0.0,0,0,11,0,UK,671,1.8211872325051175,-0.5087243978983353,1,3,3
8,8,0,0,1,0.0,0,0,16,0,France,329,1.049729557348179,0.3009051053742676,1,3,0
7,8,55,0,2,0.0,1,1,15,56,UK,11,-0.6139878182201407,-1.1688318447965031,3,0,1
5,8,24,0,1,0.0,0,0,13,24,Netherlands,341,0.41907861852867234,-0.8433620679895923,3,0,2
14,10,241,1,1,0.0,23,0,24,264,Italy,98,-0.8707443787293623,-0.9917389497173618,3,0,2
4,8,1,3,2,0.0,0,0,12,1,Italy,157,0.14336673193856633,0.07752807957498736,3,0,1
8,8,1,0,1,0.0,0,0,16,1,France,493,0.3736480448097513,-0.5120860575266036,3,0,2
4,8,0,0,1,0.0,0,0,12,0,Swiss,652,1.3419139293825877,0.02525760718026462,1,3,0
3,8,3,0,2,0.0,2,2,11,5,France,21,0.21183415547823295,-1.8243813911661912,3,0,3
4,8,0,1,1,0.0,0,0,12,0,UK,116,1.1139907924539865,0.32617658051470155,1,3,0
6,8,0,6,6,100.0,0,0,14,0,Italy,11,0.26105720154739886,1.8764158305682548,2,3,0
6,9,2,0,1,0.0,0,1,15,2,UK,64,-0.025444028755246727,-1.1768447451341877,3,0,2
11,8,1,1,2,100.0,6,1,19,7,Italy,137,-1.184505839436589,0.09995930239529799,0,0,1
3,8,1,3,1,0.0,0,0,11,1,Italy,84,0.8952545751914592,-0.9918458030143782,3,0,3
13,22,16,0,1,0.0,0,0,35,16,Italy,216,-0.3120130487900034,-0.5826343458271241,3,0,2
14,8,88,0,5,100.0,7,14,22,95,US,154,-1.2642711178798693,-0.365965340693784,0,0,1
6,9,1,0,1,0.0,1,2,15,2,France,25,-0.33859951289833046,-1.6292788709297246,3,0,2
4,8,1,0,1,0.0,0,0,12,1,France,404,0.6658324168441601,-0.7877335557206065,3,0,2
9,8,3,5,41,78.0,1,1,17,4,UK,11,-1.1006720809329045,-0.015497176159152455,0,0,1
4,8,0,0,4,100.0,0,0,12,0,France,60,0.7260560498462688,1.3247936447450672,2,3,0
3,8,0,0,1,0.0,0,0,11,0,France,487,1.8211872325051175,-0.5087243978983353,1,3,3
3,8,0,0,1,0.0,0,0,11,0,France,576,1.8211872325051175,-0.5087243978983353,1,3,3
3,8,0,1,1,0.0,0,0,11,0,France,17,1.5932640955765158,-0.20780542456389847,1,3,3
25,52,733,0,3,0.0,67,11,77,800,Italy,13,-1.734939923841112,-1.2587887396821864,0,0,1
7,8,1,1,2,0.0,0,0,15,1,Italy,13,-0.08107054778794691,0.28103368904935133,2,0,1
6,8,0,0,1,0.0,0,0,14,0,UK,399,1.1552922511386414,0.2014957695955512,1,3,0
35,10,9,7,22,88.8,7,4,45,16,Italy,11,-1.7433236343051628,0.02869542638500861,0,0,1
15,8,0,2,21,80.0,0,0,23,0,France,509,0.11979634361088846,1.8523643405803618,2,3,0
8,9,118,0,2,100.0,25,4,17,143,Italy,17,-1.2907647444841008,-0.6445877215124771,0,0,1
5,8,0,0,1,0.0,0,0,13,0,UK,162,1.2296015562652727,0.131225121925935,1,3,0
6,8,12,7,2,100.0,0,0,14,12,Portugal,11,-0.4828733230877276,0.8724878498068724,2,0,1
4,8,5,1,1,0.0,0,0,12,5,France,220,0.3720252063379874,-0.565943060826032,3,0,2
9,8,0,10,10,100.0,0,0,17,0,US,36,0.09227619934186254,2.0567198743454425,2,3,0
5,9,1,0,1,0.0,0,0,14,1,Kazakhstan,11,0.33566652098248845,-0.7172661135260612,3,0,2
62,16,91,8,27,41.6,106,8,78,197,Sweden,11,-2.118381289410733,-0.14611714810363766,0,0,1
3,8,0,0,1,0.0,15,3,11,15,UK,62,0.7733396753832075,-2.036738774079396,3,0,3
3,8,0,0,1,0.0,0,0,11,0,Austria,670,1.8211872325051175,-0.5087243978983353,1,3,3
5,8,5,1,1,0.0,0,0,13,5,Spain,439,0.2597128332206724,-0.4599755460803618,3,0,2
11,8,27,0,1,0.0,25,7,19,52,Germany,12,-0.544707004473139,-1.691165844773436,3,0,2
7,8,0,10,8,100.0,1,0,15,1,US,40,-0.48086335500484734,1.090784149280188,2,0,1
4,8,0,0,1,0.0,0,2,12,0,France,675,1.0628997339020334,-0.48307309939085386,1,3,0
3,8,0,0,1,0.0,0,0,11,0,UK,48,1.8211872325051175,-0.5087243978983353,1,3,3
6,8,135,8,2,0.0,20,1,14,155,Italy,15,-0.9303295387071121,-0.9982057707454013,0,0,1
10,8,8,6,3,66.0,8,4,18,16,France,11,-1.1514513018907053,-0.30382195598212003,0,0,1
3,8,0,0,1,0.0,3,19,11,3,France,22,0.799973960478881,-2.0195358173639777,3,0,3
11,9,2,0,1,0.0,0,0,20,2,Italy,427,0.07273280536123064,-0.526782995220911,3,0,2
7,8,0,7,6,100.0,0,0,15,0,Italy,14,0.1973342403058381,1.9378878617057114,2,3,0
4,8,0,0,1,0.0,0,1,12,0,France,14,1.074277107741563,-0.46234487632388527,1,3,0
28,17,19,0,2,100.0,1,0,45,20,US,231,-1.3049918845115878,0.31912998285538524,0,0,1
11,11,2280,1,1,0.0,0,70,22,2280,France,11,-0.9865411840349595,-1.3362003774833755,3,0,2
4,8,0,3,1,0.0,0,0,12,0,France,32,1.0920627846073578,0.3551273649650929,1,3,0
43,12,204,40,34,96.2,1,0,55,205,Italy,12,-1.7245507397859294,0.5434709056749366,0,0,1
4,8,0,0,1,0.0,0,0,12,0,France,420,1.3419139293825877,0.02525760718026462,1,3,0
5,8,3,1,6,50.0,0,0,13,3,Italy,45,-0.19364284935435347,0.5436380919476439,2,0,1
4,8,0,0,1,0.0,0,0,12,0,France,658,1.3419139293825877,0.02525760718026462,1,3,0
6,8,0,10,3,100.0,0,0,14,0,Italy,11,0.2706446204603645,1.8495365015138867,2,3,0
6,8,0,0,1,0.0,0,0,14,0,Swiss,255,1.1552922511386414,0.2014957695955512,1,3,0
94,9,5,10,33,28.0,0,0,103,5,Italy,77,-1.191138844754838,1.2800588602720657,0,0,1
5,8,1,3,5,100.0,0,0,13,1,Grèce,79,-0.31953329569055866,0.9620633674793876,2,0,1
4,8,0,0,1,0.0,0,3,12,0,UK,11,1.0558711913549614,-0.49587826865102175,1,3,0
5,5,0,0,1,0.0,0,0,10,0,France,505,1.9039539098763862,-0.06344546008016441,1,3,2
3,10,0,1,1,0.0,3,1,13,3,France,97,0.2020729287471298,-1.5476252582294534,3,0,3
6,8,0,0,1,0.0,0,0,14,0,Italy,620,1.1552922511386414,0.2014957695955512,1,3,0
3,8,0,0,2,0.0,0,0,11,0,France,466,1.5485726923747531,0.026667479612430312,1,3,3
8,11,26,4,4,75.0,14,20,19,40,Italy,49,-1.4908863610141314,-0.544507461765074,0,0,1
8,8,1,9,6,100.0,0,0,16,1,France,16,-0.5307485782704404,1.1762499747378374,2,0,1
15,8,0,23,17,88.0,0,0,23,0,Spain,13,0.06351703030586106,1.9267487206957479,2,3,0
5,8,27,3,1,0.0,0,0,13,27,UK,185,0.16389760718012206,-0.5199082898870075,3,0,2
12,8,2,1,6,80.0,0,0,20,2,Italy,51,-0.47959494631915145,0.8592903549608507,2,0,1
21,9,97,3,13,84.0,10,16,30,107,UK,42,-1.6736809307911227,-0.3114733391876352,0,0,1
176,60,276,18,81,92.0,1,0,236,277,Spain,11,-2.1463253676856877,0.7450875610267216,0,0,1
5,8,1,0,3,100.0,2,1,13,3,Italy,203,-0.6685541876365165,-0.37954174029447624,0,0,1
5,8,0,0,1,0.0,0,0,13,0,France,644,1.2296015562652727,0.131225121925935,1,3,0
3,10,0,3,3,100.0,0,0,13,0,Italy,87,0.541253194985336,1.173598790677558,2,3,3
5,8,0,0,1,0.0,0,0,13,0,France,333,1.2296015562652727,0.131225121925935,1,3,0
4,8,21,1,1,0.0,1,0,12,22,UK,11,-0.007500607510234459,-1.0907146713464067,3,0,2
8,8,1,0,1,0.0,0,0,16,1,US,638,0.3736480448097513,-0.5120860575266036,3,0,2
5,8,7,1,1,0.0,0,0,13,7,UK,18,0.24592247290600613,-0.47655015577002574,3,0,2
5,8,1,0,1,0.0,0,0,13,1,UK,169,0.553520043726845,-0.6817660409749365,3,0,2
4,8,0,0,1,0.0,0,0,12,0,Italy,388,1.3419139293825877,0.02525760718026462,1,3,0
7,0,133,1,1,0.0,0,2,7,133,Germany,11,0.9466585695754808,-1.1293613731601337,3,1,2
3,8,26,0,1,0.0,0,0,11,26,Belgium,17,1.0072987875143136,-1.4873687250975913,3,0,3
4,9,1,0,2,0.0,0,0,13,1,France,478,0.1481815862365917,-0.2653682312971762,3,0,2
20,8,7,10,13,61.0,2,5,28,9,France,11,-1.33872563857671,-0.003941906801138881,0,0,1
4,8,4,0,2,0.0,2,0,12,6,France,13,0.0014921909024958374,-0.7940936731855539,3,0,2
7,9,0,0,2,0.0,0,0,16,0,France,471,0.6246540164202261,0.7414233469189677,1,3,0
17,8,0,0,12,83.0,0,1,25,0,Pologne,55,0.08311734092697831,1.0401005120194413,2,3,0
23,9,1,1,4,100.0,0,0,32,1,Spain,586,-0.8996091431958845,1.2571496483900213,2,0,1
5,8,4,3,1,0.0,0,0,13,4,UK,378,0.24660649014059394,-0.4204200231742067,3,0,2
5,10,91,0,1,0.0,5,5,15,96,UK,70,-0.5982391113961415,-1.9757157028431314,3,0,2
5,8,0,0,2,0.0,0,0,13,0,UK,663,0.9569870161349094,0.6666169994367003,1,3,0
4,8,0,0,1,0.0,0,0,12,0,France,11,1.3419139293825877,0.02525760718026462,1,3,0
24,21,57,39,11,81.0,859,16,45,916,Italy,11,-2.1170505538405733,-0.4287861296701122,0,0,1
10,8,0,5,9,100.0,0,0,18,0,US,16,0.08409895138566914,2.0542972963708737,2,3,0
13,9,20,0,12,91.0,3,2,22,23,UK,84,-1.1911313971000366,-0.5313415726432866,0,0,1
4,8,0,1,1,0.0,0,0,12,0,Croatie,96,1.1139907924539865,0.32617658051470155,1,3,0
4,8,5,0,1,0.0,0,0,12,5,France,302,0.599948343266589,-0.8668620341604696,3,0,2
5,8,0,0,1,0.0,0,0,13,0,France,631,1.2296015562652727,0.131225121925935,1,3,0
9,10,35,3,3,0.0,0,0,19,35,Croatie,11,-0.6067978459272668,0.16353509429650537,0,0,1
3,9,11,1,1,0.0,3,7,12,14,France,11,-0.11700888481974712,-2.136845424761484,3,0,3
4,8,4,0,1,0.0,7,3,12,11,UK,188,-0.043565946188687574,-1.893205995616538,3,0,2
9,9,1,0,4,75.0,0,0,18,1,UK,219,-0.3161097765682173,0.4283941440681061,2,0,1
3,8,2,0,1,0.0,2,0,11,4,France,360,0.7762208979908319,-1.8362348296054403,3,0,3
7,8,0,1,3,100.0,0,0,15,0,France,11,0.261662822054314,1.8387356833848152,2,3,0
3,8,0,2,2,0.0,0,0,11,0,France,394,1.3073315359241837,0.34516976991680803,1,3,3
3,8,5,1,1,0.0,0,1,11,5,France,15,0.5836616878194919,-1.5875275494087817,3,0,3
6,8,0,0,7,85.0,0,0,14,0,France,72,0.664562574790262,1.2150460854149578,2,3,0
14,8,1,3,8,62.0,0,0,22,1,Italy,15,-0.5110689400108241,0.9587819337026644,2,0,1
4,8,0,0,4,0.0,0,0,12,0,UK,683,1.0437628384052484,0.6108011086527365,1,3,0
6,8,36,3,1,0.0,2,1,14,38,Grèce,22,-0.5223955858503498,-1.4219118453619066,3,0,2
5,8,1,0,2,100.0,5,47,13,6,France,260,-0.7529969134881249,-0.5787558300935426,0,0,1
7,8,0,0,4,75.0,0,0,15,0,Austria,214,0.6265812793297669,1.227138323786795,2,3,0
14,10,65,20,20,90.0,117,3,24,182,UK,11,-1.7269002343431816,-0.3145112356639646,0,0,1
5,8,0,0,5,100.0,0,0,13,0,Italy,204,0.6063993616230995,1.4451847725954303,2,3,0
7,8,0,0,2,100.0,0,0,15,0,Germany,35,0.505227313120103,1.5070984147081166,2,3,0
4,8,6,1,1,0.0,7,1,12,13,Islande,31,-0.26497100884679914,-1.5728985720039548,3,0,2
9,8,7,1,3,66.0,0,0,17,7,France,13,-0.4246033377305154,0.6690807061634578,2,0,1
5,22,29,20,2,100.0,0,0,27,29,France,11,-1.0747894543143233,0.8629124570078744,0,0,1
8,8,0,0,1,0.0,0,0,16,0,Estonie,652,1.049729557348179,0.3009051053742676,1,3,0
15,8,2,3,7,71.0,1,0,23,3,UK,33,-0.8788197485741045,0.48042729847749094,0,0,1
4,8,0,1,1,0.0,0,0,12,0,Spain,378,1.1139907924539865,0.32617658051470155,1,3,0
3,8,21,0,4,75.0,0,2,11,21,Italy,27,0.26922812837600385,-1.0143424057680652,3,0,3
4,8,0,0,1,0.0,0,0,12,0,US,681,1.3419139293825877,0.02525760718026462,1,3,0
5,9,69,0,1,0.0,3,0,14,72,UK,14,-0.18633502217789127,-1.4167142031645956,3,0,2
5,8,3,0,2,0.0,0,0,13,3,France,376,0.23611373135290153,-0.2001725021460501,3,0,2
17,8,1,35,31,93.0,2,0,25,3,France,11,-1.019250788920229,0.7066042583526237,0,0,1
3,10,2,1,1,0.0,0,0,13,2,France,268,0.4644169529549536,-0.982854188979074,3,0,3
31,8,6,1,24,76.0,0,0,39,6,Spain,13,-0.7878306191404215,1.0978306518339005,2,0,1
4,8,1,0,1,0.0,0,0,12,1,Italy,257,0.6658324168441601,-0.7877335557206065,3,0,2
42,79,1127,0,4,0.0,8,0,121,1135,Spain,62,-1.526635935982457,-0.5875098824345389,0,0,2
4,9,0,0,1,0.0,0,0,13,0,France,650,1.0968776389053831,0.01223105409292955,1,3,0
48,8,9,0,30,93.0,1,0,56,10,France,131,-1.0028401845226127,0.4505322290901473,0,0,1
3,8,0,0,1,0.0,0,0,11,0,Italy,11,1.8211872325051175,-0.5087243978983353,1,3,3
4,8,0,0,1,0.0,0,0,12,0,France,314,1.3419139293825877,0.02525760718026462,1,3,0
3,9,1,0,1,0.0,0,0,12,1,France,618,0.8483566161094743,-1.2919882291664586,3,0,3
14,17,160,0,2,100.0,187,5,31,347,France,11,-1.7036262414147105,-0.6288864433726068,0,0,1
7,8,0,0,2,100.0,0,0,15,0,France,561,0.505227313120103,1.5070984147081166,2,3,0
3,8,0,0,1,0.0,0,0,11,0,UK,632,1.8211872325051175,-0.5087243978983353,1,3,3
7,9,22,0,1,0.0,11,0,16,33,US,41,-0.27367078315916654,-1.2787491792345074,3,0,2
3,8,1,0,2,0.0,0,0,11,1,France,61,0.8724911798363263,-0.7863236832884407,3,0,3
8,8,8,3,2,0.0,0,5,16,8,Sweden,11,-0.5303271927262891,-0.2888622033292819,3,0,1
5,7,3,2,1,0.0,11,0,12,14,France,13,0.2285615446416197,-0.8972330677661327,3,0,2
6,9,169,0,2,100.0,103,3,15,272,Germany,52,-1.2497479383773324,-0.785443741147686,0,0,1
4,8,0,0,1,0.0,0,0,12,0,France,167,1.3419139293825877,0.02525760718026462,1,3,0
3,8,50,0,1,0.0,8,0,11,58,UK,33,0.6223303911282696,-2.0255476858101713,3,0,3
3,8,0,12,6,100.0,0,0,11,0,France,11,0.9097728630900116,1.1888769202457292,2,3,3
7,8,0,3,2,100.0,0,0,15,0,France,132,0.25537616834487276,1.8369681724929445,2,3,0
3,8,0,2,1,0.0,12,0,11,12,US,692,0.828033050369107,-1.1839983986560947,3,0,3
82,12,150,5,37,50.0,7,5,94,157,UK,106,-2.0654965443037643,-0.022866434276278394,0,0,1
4,8,4,0,2,100.0,0,1,12,4,UK,150,-0.24918814229722908,-0.09447536560575875,2,0,1
6,8,0,3,1,0.0,0,0,14,0,France,184,0.9054411063634118,0.5313655273803796,1,3,0
36,19,5598,2,4,0.0,1295,18,55,6893,Spain,12,-2.120049999853379,-1.1825238721357416,0,0,1
5,8,0,1,1,0.0,0,0,13,0,US,319,1.0016784193366715,0.43214409526037173,1,3,0
12,9,15,17,10,100.0,0,0,21,15,France,22,-0.9654610709245129,1.1314519512251169,2,0,1
6,8,3,38,4,50.0,1,0,14,4,France,11,-0.6597551787109528,0.24201716298126388,0,0,1
5,8,1,0,1,0.0,0,0,13,1,Italy,359,0.553520043726845,-0.6817660409749365,3,0,2
9,8,0,1,4,75.0,1,0,17,1,Italy,141,-0.34314184835864436,0.7293484978068587,2,0,1
9,10,34,3,9,77.0,1,0,19,35,Russia,15,-1.1288032218658564,0.16994652058737097,0,0,1
5,8,2,0,1,0.0,2,0,13,4,Italy,496,0.18463522175098795,-1.1962853097811716,3,0,2
4,8,17,3,4,100.0,0,0,12,17,Italy,11,-0.31776099963470955,0.7000260222724346,2,0,1
6,34,4,1,8,87.0,20,32,40,24,France,22,-1.7120718007174098,-0.4358301391300902,0,0,1
5,8,0,2,1,0.0,0,0,13,0,France,13,0.9883603998147029,0.44972741223031226,1,3,0
12,8,0,0,17,70.0,0,0,20,0,France,14,0.42251503440857036,1.464757817041269,2,3,0
5,8,1,0,9,100.0,0,0,13,1,UK,11,-0.0869183563803141,0.6660440580259177,2,0,1
6,8,0,0,3,100.0,0,0,14,0,France,13,0.5493295683121115,1.4815984785409098,2,3,0
12,9,462,1,2,0.0,1,5,21,463,Germany,14,-1.3294923966629952,-0.9804597596433867,0,0,1
9,9,26,19,4,75.0,0,24,18,26,Italy,11,-1.073134995323662,0.05425611787773444,0,0,1
12,8,1,1,11,100.0,0,0,20,1,Germany,146,-0.6153943334097399,1.2576900939994409,2,0,1
6,8,1,0,2,50.0,0,0,14,1,Italy,422,0.04249902019317853,0.29267727423759105,2,0,1
12,8,25,4,3,66.0,0,0,20,25,France,13,-0.5891148252433533,0.7138299974270536,2,0,1
10,8,30,2,7,57.0,0,2,18,30,UK,11,-0.835073039043455,0.17356408471216264,0,0,1
16,8,0,7,14,92.0,0,0,24,0,Sweden,15,0.08048530265685683,1.897943622303274,2,3,0
6,8,0,0,1,0.0,0,0,14,0,Spain,362,1.1552922511386414,0.2014957695955512,1,3,0
6,8,0,1,1,0.0,0,0,14,0,France,696,0.9273691142100404,0.502414742929988,1,3,0
17,4,0,6,8,100.0,0,0,21,0,UK,23,0.28764590440125737,2.2764687843498526,2,3,0
9,17,174,11,4,100.0,38,0,26,212,Italy,11,-1.6023036779031805,0.31687260755565166,0,0,1
5,11,2,1,1,0.0,0,1,16,2,France,132,-0.3386009863437452,-0.9120241313795606,3,0,2
15,9,2,1,1,0.0,0,0,24,2,France,330,-0.2245494241552435,-0.1595373422285832,3,0,2
5,8,37,6,3,100.0,1,0,13,38,Italy,13,-0.7932253199968416,0.31074625598274064,0,0,1
4,10,4,0,2,0.0,10,2,14,14,UK,32,-0.6658843078971154,-1.3532209143079248,3,0,1
4,8,0,0,1,0.0,0,0,12,0,France,675,1.3419139293825877,0.02525760718026462,1,3,0
10,8,85,2,2,50.0,0,2,18,85,UK,227,-0.8461707776381703,0.021460299968323635,0,0,1
6,8,0,0,1,0.0,0,0,14,0,Italy,615,1.1552922511386414,0.2014957695955512,1,3,0
3,8,0,0,1,0.0,0,0,11,0,France,504,1.8211872325051175,-0.5087243978983353,1,3,3
24,8,27,113,30,76.0,9,1,32,36,Italy,11,-1.5273446441143481,0.11697171885155049,0,0,1
7,8,1,0,1,0.0,3,0,15,4,France,604,0.05923241332757308,-1.0611665483421338,3,0,2
7,8,1,1,1,0.0,0,0,15,1,Netherlands,230,0.19154399234241667,-0.2543581884614142,3,0,2
5,8,0,0,1,0.0,0,0,13,0,France,683,1.2296015562652727,0.131225121925935,1,3,0
12,8,0,0,2,0.0,0,0,20,0,Sweden,12,0.6637085942019069,0.9430577206399771,1,3,0
10,8,0,7,6,100.0,0,0,18,0,France,31,0.08853967934114564,2.0404654498766845,2,3,0
6,9,4,2,1,0.0,11,0,15,15,Pologne,16,-0.40923810857917375,-0.9412986555060956,3,0,2
9,8,0,20,6,83.0,0,0,17,0,US,14,0.23603095546124525,1.7235201648017493,2,3,0
7,11,1,7,1,0.0,0,1,18,1,Netherlands,110,-0.43625765166204816,-0.7366922764354393,3,0,2
5,8,0,1,1,0.0,0,2,13,0,France,696,0.722664223856117,-0.07618661131074686,1,3,0
4,8,0,0,1,0.0,0,0,12,0,UK,693,1.3419139293825877,0.02525760718026462,1,3,0
4,8,0,2,1,0.0,0,0,12,0,France,45,1.1006727729320176,0.3437598974846426,1,3,0
7,8,2,0,2,100.0,0,0,15,2,Netherlands,18,-0.19949961958343868,0.6596989284472343,2,0,1
11,8,0,0,7,28.0,0,0,19,0,France,279,0.4825187008438956,1.3688490298806164,2,3,0
5,8,1,8,3,100.0,0,0,13,1,France,43,-0.3258957209319001,0.9593672405966006,2,0,1
7,8,0,0,2,100.0,1,1,15,1,UK,186,-0.4237971332314227,0.14486799896908334,0,0,1
4,8,7,4,2,100.0,0,0,12,7,France,11,-0.26134386591083153,0.7054942464076894,2,0,1
5,8,3,0,1,0.0,14,0,13,17,France,73,0.11223392418948351,-1.2912454631358146,3,0,2
6,8,41,1,1,0.0,138,17,14,179,Germany,13,-0.6657399718567705,-1.6976429580197758,3,0,2
10,8,0,0,2,100.0,0,0,18,0,UK,633,0.3964327521554105,1.6096760028790882,2,3,0
9,8,0,0,4,75.0,0,0,17,0,France,405,0.5461689132804577,1.303057456707305,2,3,0
5,8,8,2,1,0.0,1,1,13,9,Sweden,46,-0.3591013886152261,-1.404669539338516,3,0,2
9,8,1,2,4,0.0,0,1,17,1,France,31,-0.46797430584722527,-0.06291472060264224,0,0,1
8,9,3,0,1,0.0,0,0,17,3,France,23,0.13881190093883175,-0.6243758545170088,3,0,2
6,9,1,0,2,100.0,0,0,15,1,France,218,-0.319483115638451,0.594550475333069,2,0,1
18,10,11,0,7,100.0,3,5,28,14,France,33,-1.4230719993520178,-0.21135995723380124,0,0,1
6,8,1,0,1,0.0,0,0,14,1,France,386,0.479210738600214,-0.6114953933053203,3,0,2
12,30,196,3,6,66.0,378,27,42,574,Netherlands,15,-2.0142489873757974,-0.6444720082353799,0,0,1
6,8,1,3,5,100.0,0,0,14,1,Spain,28,-0.3938426008171897,1.0323340151490044,2,0,1
7,8,64,0,2,100.0,0,0,15,64,France,84,-0.3544295436552473,0.4734852801996804,2,0,1
11,9,32,0,1,0.0,465,2,20,497,UK,17,-0.8289596668223768,-1.8780043800673585,3,0,2
6,8,0,0,1,0.0,0,0,14,0,Italy,202,1.1552922511386414,0.2014957695955512,1,3,0
5,8,0,0,1,0.0,0,0,13,0,Swiss,501,1.2296015562652727,0.131225121925935,1,3,0
12,8,0,1,1,0.0,0,0,20,0,Spain,122,0.7083999974036687,0.7085848164636485,1,3,0
4,8,0,0,1,0.0,0,0,12,0,France,506,1.3419139293825877,0.02525760718026462,1,3,0
7,8,0,1,5,100.0,0,0,15,0,France,45,0.244423310238671,1.8725926251089526,2,3,0
6,8,11,0,1,0.0,0,0,14,11,France,12,0.38178621665245893,-0.7285452914177813,3,0,2
5,8,3,0,1,0.0,7,0,13,10,Italy,545,0.13914934996947395,-1.2554327967178796,3,0,2
19,8,0,5,6,50.0,0,0,27,0,Italy,419,0.09918917443395563,1.8268087059064497,2,3,0
7,9,214,0,1,0.0,2,4,16,216,Sweden,11,-0.651286385199043,-1.9070007113412613,3,0,2
6,8,0,0,2,100.0,0,0,14,0,France,14,0.5649709224492987,1.4508801831986478,2,3,0
4,8,0,1,3,100.0,0,0,12,0,Italy,11,0.5080281096274559,1.6062792894600606,2,3,0
3,8,1,0,2,100.0,0,0,11,1,Italy,629,0.5547843912773464,-0.07233114719611011,2,0,3
6,8,0,0,2,0.0,0,0,14,0,France,216,0.8826777110082783,0.7368876471063167,1,3,0
4,8,0,0,1,0.0,0,0,12,0,Bahamas,590,1.3419139293825877,0.02525760718026462,1,3,0
10,9,23,2,2,0.0,11,0,19,34,Germany,183,-0.8852675175361205,-0.3349760386807529,0,0,2
3,8,0,0,2,100.0,0,0,11,0,France,424,1.230865903815774,0.7406600157047611,1,3,3
53,9,3,5,106,98.0,0,0,62,3,France,11,-1.1392846847849167,1.3402664853136221,0,0,1
4,8,1,0,1,0.0,0,0,12,1,France,345,0.6658324168441601,-0.7877335557206065,3,0,2
5,8,0,1,1,0.0,0,0,13,0,US,534,1.0016784193366715,0.43214409526037173,1,3,0
8,8,38,3,9,77.0,1,3,16,39,Netherlands,12,-1.1328469008243742,-0.32359081942577805,0,0,1
5,11,8,1,4,75.0,3,0,16,11,Italy,16,-0.9352429643601554,-0.0023207876489930164,0,0,1
6,8,0,0,1,0.0,0,0,14,0,UK,616,1.1552922511386414,0.2014957695955512,1,3,0
12,11,6,8,3,100.0,5,2,23,11,Grèce,11,-1.6016997184183537,0.05663947723569366,0,0,1
9,8,89,0,2,100.0,3,21,17,92,US,76,-1.1124267147027522,-0.5379247966493099,0,0,1
6,8,2,4,3,0.0,0,0,14,2,France,13,-0.09487109600586188,0.25975293284242346,2,0,1
7,8,1,1,1,0.0,16,0,15,17,Germany,211,-0.22936530518328047,-0.8406433349588506,3,0,2
6,8,0,1,1,0.0,0,0,14,0,France,251,0.9273691142100404,0.502414742929988,1,3,0
7,8,1,0,1,0.0,1,0,15,2,Italy,120,0.08904359880235008,-1.02139138788443,3,0,2
8,9,66,1,2,50.0,1,8,17,67,US,11,-1.287497166099885,-0.5921456622839516,0,0,1
53,9,4,38,50,68.0,3,0,62,7,Spain,240,-1.4967394106488554,0.8079038912013579,0,0,1
11,8,1,2,3,100.0,0,0,19,1,France,12,-0.5634541607694069,1.1710654181129225,2,0,1
3,8,0,7,1,0.0,0,0,11,0,UK,83,1.5510304251928337,-0.15204578162785068,1,3,3
25,26,876,7,5,100.0,15,12,51,891,France,11,-2.232144805064234,-0.16997358623909636,0,0,1
3,8,0,1,1,0.0,0,0,11,0,Îles Canaries,106,1.5932640955765158,-0.20780542456389847,1,3,3
3,8,22,0,2,100.0,25,1,11,47,UK,303,-0.23265546333019854,-1.2653611052588778,3,0,3
10,10,7,1,3,100.0,8,1,20,15,UK,18,-1.484977158204966,-0.04014435957858467,0,0,1
4,8,0,0,1,0.0,0,0,12,0,France,34,1.3419139293825877,0.02525760718026462,1,3,0
11,8,33,0,3,100.0,4,1,19,37,UK,103,-1.0814573695752723,-0.299107406369013,0,0,1
9,8,1,5,8,100.0,1,0,17,2,US,34,-0.8899249208509302,0.7404834105671803,0,0,1
22,11,432,3,9,70.0,181,37,33,613,Netherlands,12,-1.9201841274998195,-0.5839234774974549,0,0,1
5,8,1,0,1,0.0,0,0,13,1,UK,365,0.553520043726845,-0.6817660409749365,3,0,2
47,8,4,9,63,98.0,1,0,55,5,Italy,12,-1.262958113614559,0.8860397887452574,0,0,1
6,8,0,3,5,100.0,0,0,14,0,Italy,13,0.28223891172123816,1.8453251780498752,2,3,0
6,8,12,0,2,100.0,0,0,14,12,UK,73,-0.2127165157754441,0.5158092335363882,2,0,1
8,8,48,0,1,0.0,29,2,16,77,France,11,-0.45889191600342466,-1.7666628169816612,3,0,2
3,8,0,0,1,0.0,0,0,11,0,UK,233,1.8211872325051175,-0.5087243978983353,1,3,3
3,8,2,0,1,0.0,0,0,11,2,France,291,1.1164602998015751,-1.356123884159217,3,0,3
4,8,0,0,1,0.0,0,0,12,0,France,696,1.3419139293825877,0.02525760718026462,1,3,0
5,8,0,0,1,0.0,0,0,13,0,France,581,1.2296015562652727,0.131225121925935,1,3,0
8,8,0,2,3,100.0,0,0,16,0,France,341,0.20252571807107853,1.8995101046240042,2,3,0
5,8,1,1,1,0.0,0,0,13,1,Italy,224,0.32559690679824355,-0.38084706764049947,3,0,2
7,8,16,4,7,100.0,0,0,15,16,Germany,11,-0.5857327883108367,0.9784034177755039,2,0,1
4,8,1,0,1,0.0,0,0,12,1,Spain,157,0.6658324168441601,-0.7877335557206065,3,0,2
3,9,0,0,1,0.0,0,0,12,0,Italy,557,1.5244381286479023,-0.47899706626558697,1,3,3
4,8,13,13,5,100.0,0,0,12,13,France,16,-0.3471998073981467,0.7765085708239432,2,0,1
4,8,0,0,1,0.0,0,0,12,0,UK,372,1.3419139293825877,0.02525760718026462,1,3,0
10,8,4,5,7,71.0,2,0,18,6,Italy,71,-0.8278735849015475,0.35152733999262886,0,0,1
5,8,2,6,3,100.0,1,0,13,3,Monaco,11,-0.6714937796252514,0.4568858398205159,2,0,1
30,8,16,13,33,96.0,97,1,38,113,Germany,12,-1.6035536384263378,0.05885720409122649,0,0,1
6,8,1,0,1,0.0,0,0,14,1,US,239,0.479210738600214,-0.6114953933053203,3,0,2
4,8,0,0,1,0.0,0,0,12,0,France,285,1.3419139293825877,0.02525760718026462,1,3,0
17,8,0,3,14,93.0,0,0,25,0,US,11,0.08861701045650895,1.8836201771215262,2,3,0
4,8,24,7,1,0.0,8,3,12,32,UK,13,-0.37977194834513267,-1.6160073351375923,3,0,2
10,8,0,2,3,0.0,0,0,18,0,Italy,11,0.45725703012663244,1.2449040524333983,2,3,0
4,8,1,2,2,0.0,0,0,12,1,France,117,0.15197672026322642,0.06616061209453662,3,0,1
4,8,3,2,8,87.0,120,7,12,123,UK,11,-0.8987338287490437,-0.7164690091526067,0,0,1
10,8,0,0,1,0.0,0,0,18,0,US,606,0.9867540808447535,0.36029158927599275,1,3,0
19,38,331,1,1,0.0,10,31,57,341,UK,11,-1.538434116575279,-1.49382602652482,0,0,2
5,9,5,0,2,100.0,0,0,14,5,Italy,20,-0.3205388812844259,0.4529898216371725,2,0,1
9,19,38,1,3,100.0,1,0,28,39,France,59,-1.415042484171018,0.4263548341552777,0,0,1
4,8,0,0,1,0.0,0,0,12,0,Italy,645,1.3419139293825877,0.02525760718026462,1,3,0
20,9,0,1,1,0.0,0,0,29,0,France,353,0.42546563746166777,0.7393703873834598,1,3,0
9,8,1,0,1,0.0,0,0,17,1,UK,679,0.33905476322170897,-0.47935802887534207,3,0,2
3,8,0,0,1,0.0,0,0,11,0,France,397,1.8211872325051175,-0.5087243978983353,1,3,3
3,8,0,1,3,0.0,0,0,11,0,France,497,1.3050082013089648,0.35830474828912956,1,3,3
7,8,0,0,7,100.0,0,0,15,0,France,523,0.4628210773959808,1.590380671595973,2,3,0
5,8,1,1,3,66.0,0,0,13,1,Pologne,125,-0.13046362333314185,0.5623757821933897,2,0,1
4,8,2,0,1,0.0,0,0,12,2,France,389,0.6371869966790464,-0.8221418790806172,3,0,2
3,8,55,0,1,0.0,21,3,11,76,Croatie,16,0.3084513738552644,-2.584305294923814,3,0,3
3,8,0,0,1,0.0,0,0,11,0,France,300,1.8211872325051175,-0.5087243978983353,1,3,3
6,8,0,0,7,85.0,0,0,14,0,France,30,0.664562574790262,1.2150460854149578,2,3,0
4,8,3,0,1,0.0,1,0,12,4,Spain,509,0.2988524392169747,-1.2974811411765397,3,0,2
6,8,55,4,3,100.0,0,0,14,55,France,12,-0.5601322743026976,0.7963597466377701,2,0,1
5,8,0,0,1,0.0,0,0,13,0,France,637,1.2296015562652727,0.131225121925935,1,3,0
5,8,7,1,4,50.0,0,0,13,7,France,13,-0.21632579634800506,0.4777741357345917,2,0,1
5,8,0,0,1,0.0,0,0,13,0,France,397,1.2296015562652727,0.131225121925935,1,3,0
7,8,0,0,1,0.0,0,0,15,0,France,578,1.0955486418094456,0.25771400110501996,1,3,0
5,8,6,0,3,33.0,0,0,13,6,France,359,0.02946094315632795,0.16165327188994313,2,0,1
7,9,102,8,9,100.0,222,28,16,324,Austria,11,-1.675268818773535,-0.37253598522738124,0,0,1
12,8,2,8,4,75.0,0,15,20,2,France,11,-0.8264699715867521,0.3156522449404185,0,0,1
5,8,0,4,1,0.0,0,0,13,0,France,11,0.9724210360918617,0.4707715985806608,1,3,0
13,8,12,3,16,81.0,1,0,21,13,Italy,40,-0.9461653730581269,0.4344827188784654,0,0,1
10,8,0,1,4,75.0,0,0,18,0,UK,497,0.2898635814364729,1.6306348852922057,2,3,0
50,8,0,44,64,93.0,0,0,58,0,Croatie,11,-0.2607252720475497,2.2834017919547707,2,3,0
4,10,28,2,1,0.0,5,0,14,33,Italy,19,-0.4070917994737951,-1.120742843373331,3,0,2
3,8,0,0,1,0.0,0,0,11,0,Italy,125,1.8211872325051175,-0.5087243978983353,1,3,3
3,8,11,0,2,50.0,0,0,11,11,UK,230,0.6109694796118987,-0.5345927913687563,3,0,3
6,8,14,2,3,0.0,10,0,14,24,Germany,24,-0.52465104022655,-0.37365759257120773,3,0,1
6,8,0,0,1,0.0,0,0,14,0,France,336,1.1552922511386414,0.2014957695955512,1,3,0
3,8,0,0,1,0.0,0,0,11,0,France,506,1.8211872325051175,-0.5087243978983353,1,3,3
3,10,9,0,2,0.0,94,1,13,103,Italy,11,-0.357133842891129,-1.9338091181359436,3,0,3
8,8,7,0,6,83.0,0,0,16,7,France,22,-0.19058699134243565,0.3932207603676119,2,0,1
3,8,2,1,1,0.0,0,0,11,2,Italy,118,0.8885371628729744,-1.0552049108247799,3,0,3
6,8,1,1,4,75.0,0,0,14,1,UK,262,-0.21767976080806667,0.6588479027108927,2,0,1
6,8,8,0,1,0.0,16,4,14,24,France,15,-0.2854809114343266,-1.790550236782324,3,0,2
13,8,0,9,10,100.0,0,0,21,0,France,21,-0.004829967595104802,2.147253892939092,2,3,0
17,9,15,3,2,100.0,11,2,26,26,Spain,12,-1.59091305120429,0.013666040458297083,0,0,1
3,8,0,0,1,0.0,0,0,11,0,Italy,26,1.8211872325051175,-0.5087243978983353,1,3,3
3,8,0,0,1,0.0,0,0,11,0,France,475,1.8211872325051175,-0.5087243978983353,1,3,3
13,9,19,18,3,100.0,0,0,22,19,Sweden,11,-0.9564594215040272,1.0622163962290865,2,0,1
5,8,1,0,1,0.0,0,0,13,1,UK,692,0.553520043726845,-0.6817660409749365,3,0,2
3,8,0,0,1,0.0,0,0,11,0,France,609,1.8211872325051175,-0.5087243978983353,1,3,3
10,9,70,5,10,90.0,1,0,19,71,Italy,12,-1.1473873482467243,0.1977815861708727,0,0,1
5,9,2,0,2,0.0,0,0,14,2,France,97,0.034406560687011076,-0.21628255937530633,3,0,2
6,9,8,0,1,0.0,0,0,15,8,France,60,0.18537298777217556,-0.7575141363611492,3,0,2
100,450,544,82,41,90.0,114,9,550,658,Italy,11,-2.6775862758388316,-0.03753674196938031,0,0,1
4,8,0,0,2,100.0,0,0,12,0,France,356,0.751592600693245,1.2746420207833602,2,3,0
8,8,0,22,15,100.0,0,0,16,0,US,13,0.09292441704064718,2.0784611730337295,2,3,0
18,8,4,202,17,92.3,31,6,26,35,Swiss,11,-1.4909633412211891,0.026105961977414882,0,0,1
3,8,0,0,1,0.0,0,0,11,0,France,425,1.8211872325051175,-0.5087243978983353,1,3,3
6,8,0,25,6,66.0,2,0,14,2,Germany,12,-0.3103401932953506,0.6801873007754632,2,0,1
5,8,0,0,1,0.0,0,0,13,0,France,412,1.2296015562652727,0.131225121925935,1,3,0
7,8,3,0,4,100.0,3,0,15,6,Netherlands,74,-0.5876057885567993,0.20161882030992437,0,0,1
8,8,3,0,3,0.0,0,0,16,3,France,336,0.04060037829862026,0.00022577664454525282,3,0,2
4,8,0,0,1,0.0,0,0,12,0,France,676,1.3419139293825877,0.02525760718026462,1,3,0
7,9,0,0,1,0.0,24,2,16,24,Italy,152,-0.16307124212578678,-1.334621827062951,3,0,2
5,8,1,0,2,100.0,5,1,13,6,Germany,25,-0.6809077708378577,-0.4474179791415453,0,0,1
4,8,8,0,1,0.0,0,0,12,8,France,18,0.5803671915654436,-0.890413753811728,3,0,2
9,8,17,16,15,90.0,4,1,17,21,UK,12,-1.197794763194418,-0.1417944731516347,0,0,1
4,8,1,0,2,0.0,0,0,12,1,Swiss,251,0.3932178767137966,-0.2523416782098411,3,0,2
4,8,76,1,1,0.0,25,5,12,101,Sweden,52,-0.42895752840829937,-1.7925289757426244,3,0,2
14,8,2,0,4,75.0,0,0,22,2,UK,149,-0.2738258002863441,0.5642672660016399,2,0,1
5,8,2,0,4,25.0,0,0,13,2,Italy,260,0.06456398297820765,0.23379543284261642,2,0,1
6,8,0,12,11,83.0,1,1,14,1,US,11,-0.5613047967802707,0.25298252980057273,0,0,1
6,9,2,1,1,0.0,0,0,15,2,France,624,0.014269655957176754,-0.38832328829560075,3,0,2
4,8,30,1,3,100.0,0,0,12,30,Austria,11,-0.3130964422352484,0.6189379841894266,2,0,1
6,8,21,2,15,100.0,0,1,14,21,France,13,-0.8167354337891127,0.45028557117276363,0,0,1
3,8,1,4,1,0.0,0,0,11,1,Luxembourg,122,0.8879251997932781,-0.9821690841444803,3,0,3
8,8,2,5,6,50.0,0,0,16,2,UK,356,-0.39166208861630475,0.7779847254774349,2,0,1
3,8,1,0,1,0.0,0,0,11,1,US,288,1.145105719966689,-1.3217155607992064,3,0,3
6,8,3,0,1,0.0,0,0,14,3,UK,100,0.43441896635663396,-0.6652937319871992,3,0,2
8,9,1,0,1,0.0,0,0,17,1,Netherlands,547,0.1836036731824117,-0.5705775158351296,3,0,2
4,8,2,1,1,0.0,0,0,12,2,France,330,0.4092638597504449,-0.5212229057461801,3,0,2
4,8,0,0,1,0.0,0,0,12,0,US,542,1.3419139293825877,0.02525760718026462,1,3,0
7,8,7,6,5,80.0,6,1,15,13,France,360,-1.0286255053936004,-0.3014725556102287,0,0,1
7,8,0,7,4,100.0,0,0,15,0,Italy,14,0.20953395496084382,1.9139286549403058,2,3,0
3,8,7,2,1,0.0,8,0,11,15,France,88,0.45992017359505155,-1.6126240730285673,3,0,3
3,8,3,6,1,0.0,0,0,11,3,Italy,11,0.8341364923231908,-1.0240890828385887,3,0,3
3,9,6,0,1,0.0,0,2,12,6,Italy,11,0.49608497898449694,-1.8883040447596129,3,0,3
6,8,11,2,2,0.0,4,5,14,15,Denmark,21,-0.7727465636770209,-0.9015359468960568,0,0,1
12,12,172,3,1,0.0,104,11,24,276,Denmark,11,-1.2510875194256694,-1.5855328778798867,0,0,2
5,8,2,0,2,0.0,0,0,13,2,Germany,614,0.2522600834313677,-0.18078248682418152,3,0,2
3,8,19,0,1,0.0,0,0,11,19,France,22,1.0228553556892876,-1.4686481914360279,3,0,3
48,28,346,3,19,89.0,1075,54,76,1421,Italy,11,-2.323239648284579,-0.4817966568459997,0,0,1
40,8,0,12,37,94.0,0,0,48,0,Italy,11,-0.16210320024043304,2.163874959964245,2,3,0
11,8,3,1,11,63.0,2,0,19,5,Italy,129,-0.8223527539657696,0.36600542461256824,0,0,1
4,8,0,0,1,0.0,0,0,12,0,France,203,1.3419139293825877,0.02525760718026462,1,3,0
9,8,0,1,1,0.0,0,0,17,0,US,664,0.7872131388315355,0.6345521073599663,1,3,0
27,8,0,1,24,90.9,0,0,35,0,Italy,38,-0.005849207185862846,1.978112377966665,2,3,0
3,9,30,0,1,0.0,1,1,12,31,Netherlands,13,0.11854297325900563,-2.403651354736709,3,0,3
36,8,45,5,22,69.2,0,0,44,45,France,14,-0.9383968005855374,1.0452936135022648,2,0,1
12,8,26,2,4,60.0,0,2,20,26,France,21,-0.8618702008545693,0.19756544010978294,0,0,1
9,8,0,8,9,88.0,0,0,17,0,France,16,0.24160976783449556,1.7270271504861299,2,3,0
9,12,142,0,1,0.0,34,23,21,176,France,13,-0.9265824873659064,-1.9518639660848622,3,0,2
3,8,0,1,1,0.0,0,0,11,0,France,27,1.5932640955765158,-0.20780542456389847,1,3,3
5,8,0,0,1,0.0,0,0,13,0,UK,32,1.2296015562652727,0.131225121925935,1,3,0
57,8,45,123,92,74.0,6,2,65,51,UK,11,-1.7954199415449166,0.3530598136539501,0,0,1
16,10,263,3,23,86.0,5,1,26,268,Spain,15,-1.6898678129139295,-0.3010719412451208,0,0,1
5,8,90,3,6,0.0,0,1,13,90,France,11,-0.4785060643197763,-0.4753496018094463,3,0,1
5,8,1,0,1,0.0,1,4,13,2,US,513,-0.06835112475792947,-1.6788632283642648,3,0,2
4,8,1,0,1,0.0,0,0,12,1,France,31,0.6658324168441601,-0.7877335557206065,3,0,2
15,21,480,3,5,83.0,7,19,36,487,UK,11,-1.9040258573580298,-0.5400457901908725,0,0,1
3,9,0,1,1,0.0,0,0,12,0,US,333,1.2965149917193006,-0.1780780929311503,1,3,3
21,31,24,0,5,100.0,1,0,52,25,US,146,-1.4032661424829393,0.34310061721877333,0,0,1
102,8,0,0,87,98.0,0,0,110,0,US,68,-0.06661341980289007,2.001661241584226,2,3,0
9,8,0,20,2,50.0,0,0,17,0,US,11,0.28387983931415905,1.6266829263209175,2,3,0
17,14,113,4,1,0.0,210,77,31,323,US,11,-1.4081657441179225,-1.6072276725185546,0,0,2
7,8,1,7,3,0.0,0,0,15,1,US,23,-0.13894557230881618,0.3675116273276607,2,0,1
3,9,55,1,1,0.0,1,0,12,56,France,23,0.12722989346110258,-1.6524133328392892,3,0,3
6,8,1,0,1,0.0,0,0,14,1,Germany,690,0.479210738600214,-0.6114953933053203,3,0,2
10,8,183,3,3,66.0,11,3,18,194,Italy,11,-1.2830315545296127,-0.5006841703277598,0,0,1
83,8,4,56,57,98.0,0,0,91,4,Taiwan,11,-1.0714361729945694,1.477629273171692,2,0,1
7,8,0,0,1,0.0,0,0,15,0,France,96,1.0955486418094456,0.25771400110501996,1,3,0
9,11,59,5,9,90.0,7,1,20,66,Netherlands,43,-1.5172382260949289,-0.3623060079273391,0,0,1
3,8,0,0,1,0.0,0,0,11,0,France,471,1.8211872325051175,-0.5087243978983353,1,3,3
12,8,3,8,12,84.0,1,0,20,4,UK,35,-0.8888490493477665,0.494540647395914,0,0,1
3,8,0,1,1,0.0,0,0,11,0,Hong Kong,92,1.5932640955765158,-0.20780542456389847,1,3,3
4,8,0,0,1,0.0,0,0,12,0,France,13,1.3419139293825877,0.02525760718026462,1,3,0
3,8,4,0,1,0.0,0,1,11,4,UK,67,0.8204064895146432,-1.877841784287455,3,0,3
6,8,3,1,3,66.0,0,0,14,3,UK,53,-0.24956470070335288,0.5788480911811272,2,0,1
5,7,1,3,1,0.0,0,0,12,1,France,344,0.6504748930152771,-0.2907375807132662,3,0,2
7,8,0,0,1,0.0,0,0,15,0,Spain,474,1.0955486418094456,0.25771400110501996,1,3,0
4,8,0,0,1,0.0,0,0,12,0,UK,247,1.3419139293825877,0.02525760718026462,1,3,0
8,9,32,0,9,77.0,4,13,17,36,Finland,20,-1.1136650450983223,-0.7821649408661087,0,0,1
5,8,0,0,1,0.0,0,0,13,0,Italy,624,1.2296015562652727,0.131225121925935,1,3,0
9,8,0,3,4,50.0,0,0,17,0,Italy,13,0.3030368617308955,1.6178271833149755,2,3,0
33,2,9,1,14,85.0,5,0,35,14,US,15,-0.8071071870967595,0.6886697140736627,2,0,1
9,8,0,0,2,0.0,0,0,17,0,Netherlands,421,0.7425217356297736,0.8690250115362944,1,3,0
4,8,0,0,1,0.0,0,0,12,0,France,341,1.3419139293825877,0.02525760718026462,1,3,0
3,8,0,1,1,0.0,0,0,11,0,France,321,1.5932640955765158,-0.20780542456389847,1,3,3
3,8,1,0,2,100.0,0,0,11,1,France,18,0.5547843912773464,-0.07233114719611011,2,0,3
10,8,8,1,11,72.0,0,0,18,8,France,358,-0.5024923421326225,0.7751737733384262,2,0,1
4,8,0,0,1,0.0,0,0,12,0,France,372,1.3419139293825877,0.02525760718026462,1,3,0
5,9,3,0,2,100.0,1,0,14,4,France,115,-0.6216347853340402,0.022370714621102114,0,0,1
10,12,0,14,4,50.0,20,2,22,20,UK,151,-1.1351191527894842,0.09053678931010999,0,0,1
8,8,0,0,5,60.0,0,5,16,0,UK,11,0.28229137662568315,0.734343475918379,2,3,0
4,9,53,2,2,100.0,1,0,13,54,France,433,-0.9019004636856727,0.1082703498616438,0,0,1
17,5,40,7,15,82.0,0,0,22,40,France,11,-0.45531312181274247,0.999341285327139,2,0,1
4,8,12,0,4,50.0,0,0,12,12,Singapour,130,0.10197822190383372,0.04451094902262281,2,0,1
3,8,0,0,1,0.0,0,0,11,0,UK,26,1.8211872325051175,-0.5087243978983353,1,3,3
9,8,1,1,1,0.0,0,0,17,1,US,631,0.11113162629310748,-0.17843905554090483,3,0,2
10,8,0,1,1,0.0,0,0,18,0,Spain,451,0.7588309439161521,0.6612105626104299,1,3,0
20,8,7,1,15,43.0,0,0,28,7,UK,395,-0.6619187791261686,0.9402379570835145,2,0,1
17,11,2,0,5,80.0,2,3,28,4,Austria,45,-1.2158240709048524,-0.4732901472744127,0,0,1
4,8,0,0,1,0.0,0,0,12,0,France,322,1.3419139293825877,0.02525760718026462,1,3,0
3,8,0,0,1,0.0,0,0,11,0,Portugal,24,1.8211872325051175,-0.5087243978983353,1,3,3
8,10,116,7,3,0.0,23,0,18,139,Italy,70,-1.033413554992095,-0.4428611529976098,0,0,2
7,8,17,1,5,80.0,0,0,15,17,Romania,59,-0.40475301129503155,0.5925650252793684,2,0,1
5,10,65,3,1,0.0,1,1,15,66,Italy,14,-0.7733634385664055,-1.5331462603787267,3,0,2
5,10,0,0,1,0.0,0,0,15,0,France,50,0.9210406923879934,0.10803644771039571,1,3,0
3,8,1,2,1,0.0,0,0,11,1,UK,462,0.9038645635161191,-1.0032132704948284,3,0,3
4,8,1,0,1,0.0,0,0,12,1,Italy,629,0.6658324168441601,-0.7877335557206065,3,0,2
7,11,38,0,1,0.0,3,2,18,41,France,37,-0.6706409769533891,-1.778968950115901,3,0,2
5,10,0,6,11,100.0,0,0,15,0,Italy,11,0.007150418713094285,1.821557704789556,2,3,0
8,8,0,0,1,0.0,0,0,16,0,Bulgaria,601,1.049729557348179,0.3009051053742676,1,3,0
12,22,74,0,1,0.0,278,4,34,352,France,16,-1.1270701180062854,-1.863093584804861,0,0,2
3,8,0,0,1,0.0,0,0,11,0,US,670,1.8211872325051175,-0.5087243978983353,1,3,3
4,9,19,3,1,0.0,1,2,13,20,UK,18,-0.5480211843842798,-1.5765650616073508,3,0,2
3,8,0,0,1,0.0,0,0,11,0,France,681,1.8211872325051175,-0.5087243978983353,1,3,3
16,8,0,2,4,100.0,1,0,24,1,France,31,-0.6485686475783503,1.2137929085886985,2,0,1
5,8,0,0,2,0.0,0,0,13,0,Germany,203,0.9569870161349094,0.6666169994367003,1,3,0
4,9,4,0,2,0.0,0,0,13,4,France,22,0.09111917742557067,-0.33389197128127485,3,0,2
3,8,32,0,1,0.0,0,0,11,32,France,577,0.996686320805438,-1.5001109533613188,3,0,3
3,8,0,0,1,0.0,0,0,11,0,Italy,659,1.8211872325051175,-0.5087243978983353,1,3,3
6,8,7,0,2,100.0,15,2,14,22,Netherlands,160,-0.8574835224549964,-0.5112409810328941,0,0,1
31,8,0,5,9,88.0,0,0,39,0,Italy,68,-0.04607664143098581,1.9932196888208447,2,3,0
8,11,549,5,1,0.0,8,10,19,557,Germany,11,-1.1599617717079391,-1.6552374442231967,0,0,2
5,8,4,0,1,0.0,0,0,13,4,UK,33,0.49645763491582406,-0.7502897809590352,3,0,2
4,8,9,1,1,0.0,113,5,12,122,France,14,-0.4041095818709685,-1.7691648904742878,3,0,2
7,8,0,1,10,60.0,0,0,15,0,France,13,0.37525871758572465,1.5726179946681589,2,3,0
3,9,0,0,1,0.0,0,0,12,0,France,688,1.5244381286479023,-0.47899706626558697,1,3,3
6,8,0,0,3,66.0,0,0,14,0,Belgium,230,0.6992317210072565,1.14471861942944,2,3,0
6,8,0,0,1,0.0,0,0,14,0,UK,634,1.1552922511386414,0.2014957695955512,1,3,0
11,8,0,0,2,100.0,0,0,19,0,France,169,0.36950986235677846,1.6348359953671523,2,3,0
7,8,0,0,1,0.0,0,0,15,0,US,665,1.0955486418094456,0.25771400110501996,1,3,0
8,10,22,0,1,0.0,0,0,18,22,France,149,-0.015377835923388195,-0.7333791233103971,3,0,2
6,8,1,1,2,100.0,0,0,14,1,France,373,-0.3390337270177306,0.9388079936322132,2,0,1
16,8,0,25,9,100.0,0,0,24,0,US,131,-0.07236330328015966,2.216705293479669,2,3,0
5,8,12,0,1,0.0,0,0,13,12,Netherlands,36,0.45191411804052994,-0.8038458277363247,3,0,2
6,9,33,0,1,0.0,3,2,15,36,UK,49,-0.49386039357793915,-1.8190261134240626,3,0,2
7,8,0,0,2,100.0,0,0,15,0,US,167,0.505227313120103,1.5070984147081166,2,3,0
5,8,0,6,6,100.0,0,0,13,0,UK,19,0.3353665066740299,1.8061451828986388,2,3,0
3,8,0,0,1,0.0,0,0,11,0,France,528,1.8211872325051175,-0.5087243978983353,1,3,3
5,9,2,0,1,0.0,0,0,14,2,UK,505,0.30702110081737444,-0.7516744368860718,3,0,2
10,8,7,3,2,100.0,1,0,18,8,Sweden,26,-0.9287295165947874,0.578152246708874,0,0,1
3,8,128,0,1,0.0,0,5,11,128,Denmark,39,0.6255807077090774,-2.129637316216355,3,0,3
3,8,0,0,1,0.0,0,0,11,0,France,650,1.8211872325051175,-0.5087243978983353,1,3,3
15,9,4,0,1,0.0,0,7,24,4,Australia,79,-0.32713071792991777,-1.0449391520339817,3,0,2
4,8,9,6,2,0.0,2,0,12,11,Belgium,133,-0.293444837693152,-0.4771039149617162,3,0,1
53,61,1160,62,45,80.0,4,69,114,1164,US,11,-2.4378544749236806,-0.2225515280535917,0,0,1
8,10,16,0,3,0.0,134,10,18,150,UK,12,-1.0508703322963153,-1.3443422399606562,0,0,1
10,8,16,0,1,0.0,0,0,18,16,Germany,13,0.1953807353113472,-0.5912321411992028,3,0,2
13,10,0,0,1,0.0,0,0,23,0,France,196,0.6797528745455506,0.3440287899904325,1,3,0
3,8,0,1,2,0.0,14,0,11,14,France,66,0.5622560726264164,-0.6747918997435332,3,0,3
4,8,0,0,1,0.0,0,0,12,0,US,352,1.3419139293825877,0.02525760718026462,1,3,0
5,8,0,0,1,0.0,1,0,13,1,France,191,0.5682139315547723,-0.7434028103089481,3,0,1
3,8,0,1,2,0.0,0,0,11,0,Italy,19,1.320649555446152,0.3275864529468673,1,3,3
5,8,0,0,1,0.0,0,0,13,0,France,223,1.2296015562652727,0.131225121925935,1,3,0
9,8,9,0,1,0.0,1113,66,17,1122,Spain,12,-0.6857308940786583,-2.028276754016365,3,0,2
10,8,0,0,1,0.0,0,0,18,0,Spain,578,0.9867540808447535,0.36029158927599275,1,3,0
14,9,1,5,4,0.0,0,0,23,1,France,327,-0.5132810848652627,0.49146658120675313,2,0,1
11,8,1,1,1,0.0,1,0,19,2,Spain,584,-0.2745969888895759,-0.5927348338909553,3,0,2
26,44,1,0,9,53.0,0,0,70,1,France,210,-0.8973714619035338,0.6922614451751894,0,0,1
3,8,0,0,3,0.0,0,0,11,0,UK,34,1.5329313382375664,0.05738577495469308,1,3,3
4,8,8,3,2,100.0,0,0,12,8,Italy,130,-0.2598052818991295,0.6888404175761966,2,0,1
43,16,31,0,3,100.0,2,2,59,33,US,12,-1.7045602441091288,-0.12274627010607132,0,0,1
34,9,46,25,27,96.0,0,0,43,46,France,12,-1.1579932089846978,1.0521913496202595,0,0,1
13,10,4,0,1,0.0,2,2,23,6,Sweden,550,-0.6670685192847325,-1.5190450744572697,3,0,2
23,8,2,1,1,0.0,1916,405,31,1918,Belgium,29,-1.3708485029598814,-1.9097411596229277,0,0,2
9,8,338,6,1,0.0,224,14,17,562,US,11,-0.944678652122864,-1.6350018221306106,3,0,2
3,8,27,0,1,0.0,2,2,11,29,UK,17,0.398270303351851,-2.4631235796621276,3,0,3
4,10,32,50,4,75.0,0,0,14,32,Italy,11,-0.6129532041108736,0.4278525082221698,2,0,1
17,9,70,4,7,42.0,1,0,26,71,US,11,-1.2323213299469251,0.24507544586624933,0,0,1
3,8,3,3,1,0.0,1,0,11,4,Belgium,14,0.5282745975642738,-1.5015933884703108,3,0,3
23,22,28,23,60,96.4,139,6,45,167,UK,11,-2.0308646641101418,-0.14343183092667275,0,0,1
125,500,7044,117,67,90.0,664,0,625,7708,Sweden,16,-2.8623349918944134,0.033539154041800676,0,0,1
4,8,0,0,1,0.0,0,0,12,0,UK,693,1.3419139293825877,0.02525760718026462,1,3,0
4,8,0,2,1,0.0,0,1,12,0,US,19,0.8330359512909932,-0.14384258601950745,1,3,0
18,9,1,2,6,83.0,0,0,27,1,France,12,-0.7290596037201728,0.9268935019406062,2,0,1
23,8,2,0,11,100.0,0,0,31,2,US,186,-0.5574899084405326,1.0555631953795825,2,0,1
17,9,71,6,4,0.0,120,3,26,191,Swiss,15,-1.454600542106218,-0.8096394300953442,0,0,1
4,8,0,1,1,0.0,0,0,12,0,Spain,640,1.1139907924539865,0.32617658051470155,1,3,0
74,161,151,7,13,92.0,23,0,235,174,Italy,12,-2.074343613197636,0.4761491607228197,0,0,1
7,9,1,0,1,0.0,0,1,16,1,UK,471,-0.04644977762886339,-1.094562176996818,3,0,2
4,8,2,0,2,0.0,1,0,12,3,Italy,12,0.04034419158814915,-0.7452173230022437,3,0,2
5,9,19,1,2,100.0,1,4,14,20,Germany,44,-1.2139775531470132,-0.2952896919023969,0,0,1
3,8,32,5,2,100.0,1,0,11,33,UK,13,-0.17325357464431387,-0.35457229611954677,3,0,3
23,35,5,4,7,100.0,4,0,58,9,US,15,-1.6633188166896293,0.7610676223600924,0,0,1
3,8,0,3,2,0.0,0,0,11,0,US,135,1.2987215475995235,0.3565372373972588,1,3,3
7,8,3,3,6,50.0,0,2,15,3,UK,47,-0.6286379671373635,0.19074704900600165,0,0,1
9,17,56,4,2,100.0,3,4,26,59,Belgium,21,-1.7318624882713505,-0.15164677442623875,0,0,1
8,8,0,0,3,66.0,0,0,16,0,France,584,0.5936690272167936,1.2441279552081566,2,3,0
16,22,20,0,2,100.0,14,2,38,34,US,33,-1.6017943564219306,-0.34568559662961634,0,0,1
8,8,41,1,2,100.0,50,1,16,91,Belgium,15,-1.274072655559219,-0.20753586698612697,0,0,1
4,8,1,0,1,0.0,0,0,12,1,France,516,0.6658324168441601,-0.7877335557206065,3,0,2
3,8,0,0,1,0.0,1,0,11,1,Germany,263,1.1597996077946164,-1.383352330133218,3,0,3
4,8,2,1,1,0.0,0,3,12,2,France,17,0.12322112172281868,-1.0423587815774664,3,0,2
4,8,0,1,4,100.0,0,0,12,0,France,45,0.49813291291766776,1.6257126180795047,2,3,0
18,8,8,0,3,66.0,0,0,26,8,Spain,13,-0.37092216510845455,0.5197947572324572,2,0,1
4,8,5,0,1,0.0,5,1,12,10,Italy,362,-0.021915637797741545,-1.854444144722694,3,0,2
19,10,14,54,12,83.3,108,20,29,122,Spain,22,-1.7730747147400197,-0.2722121867296796,0,0,1
12,8,90,4,6,33.0,0,0,20,90,Spain,244,-0.6740228046684783,0.6636645708017651,2,0,1
8,8,367,14,2,50.0,1,19,16,368,Romania,11,-1.2721867750910214,-0.6061218071148813,0,0,1
4,8,0,2,2,100.0,0,0,12,0,France,15,0.5103514442426749,1.5931443110877388,2,3,0
11,8,1,2,4,100.0,0,0,19,1,Germany,64,-0.5733493574791952,1.190498746732366,2,0,1
5,8,0,0,1,0.0,0,0,13,0,France,366,1.2296015562652727,0.131225121925935,1,3,0
4,8,0,0,1,0.0,0,0,12,0,France,260,1.3419139293825877,0.02525760718026462,1,3,0
3,8,5,0,1,0.0,0,4,11,5,Germany,48,0.7877740083730115,-1.9318270005398177,3,0,3
3,9,10,1,2,100.0,79,2,12,89,Bulgaria,12,-0.7831039298800414,-0.9773895660367002,0,0,3
4,8,0,0,1,0.0,0,0,12,0,France,418,1.3419139293825877,0.02525760718026462,1,3,0
4,8,0,0,2,0.0,0,0,12,0,Belgium,573,1.0692993892522245,0.5606494846910298,1,3,0
6,8,0,0,4,75.0,3,0,14,3,Belgium,227,-0.01310924661137767,0.2463520202702155,2,0,1
7,8,13,0,2,100.0,3,4,15,16,Germany,192,-0.9050327005277352,-0.4411504156777729,0,0,1
13,21,8,0,1,0.0,9,0,34,17,Spain,689,-0.636116131740899,-1.066326807100266,3,0,2
4,8,0,0,2,50.0,0,0,12,0,France,103,0.9052022109755525,0.9294302747231757,1,3,0
3,8,4,3,1,0.0,2,0,11,6,UK,13,0.5035288893801584,-1.5335977979900905,3,0,3
12,8,0,0,7,100.0,0,0,20,0,UK,251,0.3035955699188048,1.7403325136201648,2,3,0
11,8,1,4,9,50.0,0,0,19,1,Spain,17,-0.46025963149056914,0.9146052484585812,2,0,1
4,8,0,4,4,60.0,0,0,12,0,France,32,0.6206838709442656,1.3231764242815602,2,3,0
8,10,176,8,7,100.0,28,1,18,204,France,11,-1.6773077317088823,-0.19438276038089838,0,0,1
4,8,1,1,1,0.0,1,0,12,2,Sweden,83,0.10748574944689043,-0.9529288084747479,3,0,2
3,8,0,1,1,0.0,0,0,11,0,US,297,1.5932640955765158,-0.20780542456389847,1,3,3
28,8,83,34,51,100.0,25,8,36,108,UK,12,-1.8112899505307645,0.3069865383946972,0,0,1
5,8,0,1,1,0.0,0,0,13,0,France,16,1.0016784193366715,0.43214409526037173,1,3,0
4,8,0,0,2,100.0,0,0,12,0,France,659,0.751592600693245,1.2746420207833602,2,3,0
4,8,0,1,2,0.0,0,0,12,0,Italy,223,0.8413762523236232,0.8615684580254667,1,3,0
5,8,0,0,1,0.0,0,0,13,0,France,456,1.2296015562652727,0.131225121925935,1,3,0
12,10,2,1,1,0.0,0,0,22,2,UK,455,-0.23567669089679175,-0.21922405105540146,3,0,2
6,4,0,1,2,100.0,0,0,10,0,France,260,1.075297636229775,1.5198148904817603,2,3,2
4,8,0,0,2,100.0,0,0,12,0,Belgium,51,0.751592600693245,1.2746420207833602,2,3,0
7,8,1,0,1,0.0,0,0,15,1,Monaco,91,0.41946712927101826,-0.5552771617958514,3,0,2
4,8,0,5,7,100.0,0,0,12,0,UK,18,0.4469696356171974,1.7041198857652438,2,3,0
8,14,2,3,1,0.0,12,3,22,14,Italy,11,-0.9728704365436386,-1.3374010866068105,0,0,2
18,9,4,9,18,100.0,3,1,27,7,France,15,-1.6118711353506483,0.3237403494613949,0,0,1
7,11,19,1,2,0.0,1,1,18,20,France,13,-1.1065904919041802,-0.8544040458738409,0,0,1
9,12,5,2,2,0.0,1,0,21,6,Italy,22,-0.8900930591179829,-0.22188395817823145,0,0,2
7,8,1,2,4,100.0,0,0,15,1,France,12,-0.43763190671587066,1.0627611660733287,2,0,1
11,8,0,11,3,66.0,0,0,19,0,Spain,17,0.22254819109211832,1.6999626563827184,2,3,0
3,8,0,0,1,0.0,0,0,11,0,UK,12,1.8211872325051175,-0.5087243978983353,1,3,3
5,8,2,0,2,100.0,0,0,13,2,Italy,363,-0.06544670512761175,0.5332100492681495,2,0,1
4,8,0,1,1,0.0,0,0,12,0,France,339,1.1139907924539865,0.32617658051470155,1,3,0
4,8,3,0,1,0.0,0,5,12,3,Germany,292,0.32499631724885,-1.3808894774096363,3,0,2
3,8,0,1,1,0.0,0,0,11,0,Italy,205,1.5932640955765158,-0.20780542456389847,1,3,3
58,48,593,39,47,93.0,66,1,106,659,Spain,11,-2.3433294254434704,-0.07449351764060262,0,0,1
4,8,1,0,1,0.0,7,0,12,8,US,629,0.27779611677066784,-1.3303841786231874,3,0,2
4,8,6,5,6,83.0,1,0,12,7,France,120,-0.4738901777838606,0.018623862280760132,0,0,1
10,8,0,0,2,66.0,0,0,18,0,UK,132,0.5463349048505555,1.2727961437676198,2,3,0
5,8,2,4,4,100.0,0,0,13,2,UK,11,-0.3481637761479986,0.9229081498845818,2,0,1
4,8,37,1,5,60.0,0,0,12,37,France,17,-0.1906243867842912,0.29708597822367766,2,0,1
3,8,0,0,1,0.0,0,0,11,0,France,416,1.8211872325051175,-0.5087243978983353,1,3,3
10,9,20,5,6,33.0,1,8,19,21,Denmark,15,-1.3576870811565347,-0.3501637665057662,0,0,1
5,11,0,0,1,0.0,5,0,16,5,Germany,359,0.1438290417345142,-0.8267540963084895,3,0,2
167,8,0,25,125,100.0,0,0,175,0,US,22,-0.6182207728964417,2.834848244205486,2,3,0
3,8,1,2,1,0.0,0,0,11,1,UK,71,0.9038645635161191,-1.0032132704948284,3,0,3
6,11,6,13,6,57.0,1,9,17,7,France,11,-1.3212418677960762,-0.38563664199913156,0,0,1
10,8,21,18,16,100.0,1,0,18,22,Italy,11,-1.0862939699764385,0.7149485157800946,0,0,1
3,8,0,0,1,0.0,0,0,11,0,Italy,604,1.8211872325051175,-0.5087243978983353,1,3,3
5,8,0,9,14,100.0,0,0,13,0,Italy,13,0.2964690863399343,1.8759959246429279,2,3,0
33,8,563,1,1,0.0,410,9,41,973,France,11,-1.2574655382298898,-1.4372551588772524,0,0,2
5,8,3,0,1,0.0,6,2,13,9,Germany,59,-0.13584176576946322,-1.7583379286055667,3,0,2
38,14,166,7,9,77.0,16,6,52,182,Grèce,11,-1.968657062538039,-0.2514390493365276,0,0,1
4,10,0,0,1,0.0,0,0,14,0,UK,132,0.9966893005774258,0.03238092484209794,1,3,0
25,8,5,0,2,100.0,2,0,33,7,US,205,-0.8912696222510067,0.4453729814501787,0,0,1
5,8,7,0,2,100.0,0,0,13,7,Italy,589,-0.11647571885473544,0.4719152844986335,2,0,1
3,8,0,0,1,0.0,0,0,11,0,Belgium,471,1.8211872325051175,-0.5087243978983353,1,3,3
16,8,9,0,2,100.0,17,0,24,26,France,519,-0.875422088169045,0.2515933896717713,0,0,1
22,8,0,0,1,0.0,0,0,30,0,Germany,664,0.8063060927681279,0.5302975016732607,1,3,0
16,21,85,2,3,25.0,4,2,37,89,Germany,324,-1.7277366697175385,-0.3928793236174996,0,0,1
13,8,3,4,1,0.0,0,0,21,3,Italy,11,-0.06236961509512917,-0.09997863727010156,3,0,2
7,9,55,1,1,0.0,13,5,16,68,France,15,-0.8411733923138505,-1.570200624431993,3,0,2
13,8,0,0,1,0.0,0,0,21,0,UK,269,0.9156841898602898,0.4272643876579225,1,3,0
8,8,18,0,1,0.0,0,4,16,18,US,14,-0.03763426015608864,-1.1870787730671513,3,0,2
7,8,1,0,1,0.0,0,0,15,1,France,310,0.41946712927101826,-0.5552771617958514,3,0,2
3,8,0,1,3,66.0,0,3,11,0,France,76,0.8511608274175041,0.2142815494387043,1,3,3
9,8,0,0,2,50.0,0,0,17,0,Germany,511,0.5784245573531016,1.2378058015684406,2,3,0
4,8,5,1,1,0.0,0,0,12,5,France,13,0.3720252063379874,-0.565943060826032,3,0,2
3,9,103,0,1,0.0,3,1,12,106,France,13,0.0372832944453891,-2.5047628777460758,3,0,3
3,8,88,2,1,0.0,0,1,11,88,France,18,0.434362606335088,-1.7333634808812062,3,0,3
4,20,1,0,1,0.0,0,0,24,1,US,376,0.018742925030105606,-0.6608086147398577,3,0,2
5,8,1,0,2,0.0,0,1,13,1,France,45,0.013268681955456526,-0.6339766469683208,3,0,1
7,8,1,1,1,0.0,1,0,15,2,France,583,-0.13887953812625148,-0.7204724145499927,3,0,2
6,8,0,0,1,0.0,0,0,14,0,Sweden,683,1.1552922511386414,0.2014957695955512,1,3,0
3,8,0,1,1,0.0,0,1,11,0,Germany,57,1.325627273935491,-0.6954079080680482,1,3,3
4,8,0,0,1,0.0,0,0,12,0,France,272,1.3419139293825877,0.02525760718026462,1,3,0
5,10,14,0,1,0.0,0,3,15,14,US,123,-0.14943016193032724,-1.3562608580050404,3,0,2
33,11,459,11,6,83.0,56,65,44,515,Spain,11,-2.0193470850930195,-0.453742726919332,0,0,1
18,9,1,5,3,100.0,0,0,27,1,France,11,-0.8714372571881087,1.2336796226518723,2,0,1
4,0,7,1,1,0.0,94,1,4,101,UK,11,0.8094619779032741,-1.723902861264964,3,1,2
4,8,0,0,1,0.0,0,0,12,0,France,173,1.3419139293825877,0.02525760718026462,1,3,0
6,8,1,1,2,0.0,0,0,14,1,Romania,12,-0.02132693845875103,0.2248154575398825,2,0,1
4,8,7,0,2,100.0,0,0,12,7,Italy,241,-0.004163345737420451,0.3659477697529634,2,0,1
8,8,44,0,1,0.0,14,0,16,58,Italy,13,-0.15865277232132458,-1.2300306044857083,3,0,2
8,8,8,0,2,100.0,0,0,16,8,Spain,14,-0.3021385091583081,0.6346181579853712,2,0,1
11,8,5,0,1,0.0,0,0,19,5,Russia,625,0.21786560493012244,-0.5066680595766767,3,0,2
10,8,55,12,1,0.0,0,0,18,55,US,627,-0.1488840168204259,-0.2903875454680164,3,0,2
6,8,2,0,3,0.0,3,0,14,5,France,521,-0.18834168109097635,-0.5738537428809274,3,0,2
13,9,0,1,2,0.0,1,0,22,1,Italy,470,-0.4231373647458674,0.319585560340079,0,0,1
7,8,0,37,30,90.0,0,0,15,0,UK,13,0.2450678529099467,1.7796341615252773,2,3,0
29,8,2,13,26,100.0,0,0,37,2,UK,11,-0.9273304498010652,1.5385896614422838,2,0,1
8,14,3,0,1,0.0,11,0,22,14,Italy,80,-0.4427672494775689,-1.152279244218022,3,0,2
17,8,40,3,23,95.0,0,7,25,40,France,11,-1.0655108366499273,0.35558344996142977,0,0,1
5,8,0,0,4,50.0,0,0,13,0,Italy,145,0.767353287011262,1.0855494134305521,2,3,0
111,37,237,7,35,91.0,2,1,148,239,France,11,-2.2322909493104386,0.07701420621953185,0,0,1
5,8,5,2,1,0.0,5,1,13,10,Hong Kong,13,-0.37546916736562663,-1.4299743396726463,3,0,2
4,8,3,12,6,83.0,0,0,12,3,Germany,39,-0.14687673288315084,0.533584085435113,2,0,1
3,8,0,0,1,0.0,0,0,11,0,Italy,140,1.8211872325051175,-0.5087243978983353,1,3,3
3,8,0,0,1,0.0,0,0,11,0,Denmark,93,1.8211872325051175,-0.5087243978983353,1,3,3
5,9,21,11,3,0.0,0,0,14,21,Italy,11,-0.36170787673813226,0.06641182303222218,3,0,1
14,10,295,1,4,50.0,0,0,24,295,Denmark,11,-0.9724621164997662,0.4756485348016965,0,0,1
4,8,0,2,1,0.0,0,0,12,0,Spain,168,1.1006727729320176,0.3437598974846426,1,3,0
8,8,0,0,3,100.0,0,3,16,0,France,20,0.15772413649402256,1.0598719384883393,2,3,0
6,8,1,4,7,100.0,0,0,14,1,France,12,-0.41069734598666235,1.0607177538403592,2,0,1
17,8,2,0,12,83.0,0,0,25,2,UK,418,-0.3539727701355385,0.6803035092627094,2,0,1
9,8,0,0,1,0.0,0,0,17,0,Spain,653,1.0151362757601365,0.3336331340255292,1,3,0
7,9,14,3,1,0.0,4,1,16,18,Spain,43,-0.7483227182812178,-1.381207991231106,3,0,2
12,22,46,0,1,0.0,12,2,34,58,Pologne,12,-0.9930635714507738,-1.6806828850088782,0,0,2
7,9,8,1,6,83.0,29,0,16,37,Italy,20,-0.9857336054017214,0.01898137534595151,0,0,1
7,8,97,3,3,100.0,4,0,15,101,Belgium,40,-0.9827338708976061,0.3249219890253074,0,0,1
3,8,1,1,1,0.0,0,0,11,1,France,130,0.9171825830380879,-1.020796587464769,3,0,3
9,13,103,4,6,83.0,201,0,22,304,Spain,14,-1.4059072309971714,-0.0689943561184014,0,0,1
21,16,5979,1,6,100.0,634,40,37,6613,Hong Kong,62,-2.3071194341614265,-0.5531996540121527,0,0,1
12,12,8,2,2,0.0,0,0,24,8,UK,15,-0.6445280557404408,0.26203772749267684,0,0,1
3,8,0,0,1,0.0,0,0,11,0,UK,334,1.8211872325051175,-0.5087243978983353,1,3,3
7,8,4,31,21,100.0,0,0,15,4,France,11,-0.6118289676699138,1.1826679061047887,2,0,1
8,8,2,12,16,100.0,0,0,16,2,Italy,13,-0.59895800255085,1.215025032200791,2,0,1
6,8,3,0,1,0.0,0,0,14,3,France,664,0.43441896635663396,-0.6652937319871992,3,0,2
8,10,87,1,1,0.0,5,2,18,92,Netherlands,120,-0.9362134297773174,-1.51207217781941,0,0,2
8,8,0,0,1,0.0,0,0,16,0,Italy,288,1.049729557348179,0.3009051053742676,1,3,0
8,8,0,0,1,0.0,0,0,16,0,France,686,1.049729557348179,0.3009051053742676,1,3,0
8,8,2,0,1,0.0,0,0,16,2,UK,26,0.3450026246446375,-0.5464943808866141,3,0,2
8,8,0,0,2,0.0,0,0,16,0,France,586,0.7771150172178157,0.8362969828850333,1,3,0
4,8,0,0,1,0.0,0,0,12,0,France,470,1.3419139293825877,0.02525760718026462,1,3,0
6,11,0,2,6,100.0,0,0,17,0,France,38,-0.05411299972208554,1.8113356615978335,2,3,0
4,8,1,1,2,100.0,0,0,12,1,France,12,-0.15241204877378448,0.7625698312169267,2,0,1
4,8,0,2,1,0.0,0,0,12,0,France,363,1.1006727729320176,0.3437598974846426,1,3,0
5,10,1,0,2,100.0,1,0,15,2,France,72,-0.6757856793084456,0.07831547232404244,0,0,1
6,9,241,0,1,0.0,30,4,15,271,Germany,11,-0.657376989497046,-2.0320512602477896,3,0,2
6,8,0,0,2,100.0,0,0,14,0,US,371,0.5649709224492987,1.4508801831986478,2,3,0
6,8,1,6,1,0.0,0,0,14,1,France,318,0.21303328320029546,-0.2600705766628236,3,0,2
16,10,153,0,3,100.0,2,6,26,155,Germany,13,-1.5024433210112977,-0.43986845570409605,0,0,1
5,10,2,0,1,0.0,0,0,15,2,France,30,0.21631375968445177,-0.7393630385504857,3,0,2
5,9,0,0,2,100.0,0,0,14,0,Italy,16,0.4214267048315731,1.3451094629779061,2,3,0
14,8,31,17,24,83.0,1,0,22,32,Germany,15,-1.0589259339482464,0.47463809945661173,0,0,1
3,8,1,0,1,0.0,0,0,11,1,France,655,1.145105719966689,-1.3217155607992064,3,0,3
5,8,0,0,1,0.0,0,0,13,0,France,607,1.2296015562652727,0.131225121925935,1,3,0
10,9,53,1,12,91.0,160,7,19,213,Sweden,11,-1.530786297533414,-0.5297232931462686,0,0,1
20,8,203,13,22,100.0,19,5,28,222,UK,14,-1.7206629548807624,0.11451103276397591,0,0,1
7,8,10,1,9,100.0,0,0,15,10,France,89,-0.5420207804107477,0.9815912937401516,2,0,1
16,8,0,14,10,100.0,0,0,24,0,US,523,-0.060968698635521165,2.2040665401372173,2,3,0
17,8,23,2,11,63.0,45,12,25,68,Hong Kong,11,-1.4033663669950607,-0.2863728833006456,0,0,1
3,8,0,0,2,0.0,0,0,11,0,France,45,1.5485726923747531,0.026667479612430312,1,3,3
3,8,0,0,1,0.0,0,0,11,0,France,423,1.8211872325051175,-0.5087243978983353,1,3,3
17,15,9,1,2,100.0,0,0,32,9,Italy,15,-1.0664173328575453,1.0197007062165333,0,0,1
4,8,0,0,1,0.0,0,0,12,0,UK,548,1.3419139293825877,0.02525760718026462,1,3,0
5,8,8,0,2,0.0,1,5,13,9,Spain,13,-0.4188822780057248,-1.2395350516351296,3,0,1
7,8,23,2,6,83.0,1,0,15,24,Italy,11,-0.7561878172051542,0.1549904814033964,0,0,1
3,8,5,3,6,100.0,0,0,11,5,France,11,0.20131290742256341,0.2525209628759671,2,0,3
3,8,257,0,1,0.0,0,0,11,257,France,12,0.8814187363721275,-1.6386976862751914,3,0,3
6,8,0,0,1,0.0,0,0,14,0,France,610,1.1552922511386414,0.2014957695955512,1,3,0
3,8,0,0,1,0.0,0,0,11,0,France,513,1.8211872325051175,-0.5087243978983353,1,3,3
5,8,0,0,2,0.0,0,0,13,0,UK,11,0.9569870161349094,0.6666169994367003,1,3,0
7,9,6,6,8,100.0,0,0,16,6,UK,131,-0.7545872772842257,0.9962400715648664,2,0,1
10,8,3,26,10,0.0,155,30,18,158,France,11,-1.188321285928161,-0.7501942223314753,0,0,1
13,8,2,0,4,100.0,0,0,21,2,Belgium,34,-0.40490062237957053,0.879400938961843,2,0,1
10,10,156,1,2,100.0,1,1,20,157,Spain,15,-1.5766391579311612,-0.1924793186329247,0,0,1
13,8,3,16,28,96.0,0,0,21,3,Romania,11,-0.6356107786361147,1.0574121909968186,2,0,1
13,10,46,7,12,100.0,0,0,23,46,UK,11,-1.0861515081456774,1.054422718196729,0,0,1
25,1,0,32,28,89.0,0,0,26,0,Spain,12,0.30005584965889737,2.1788957461295158,2,3,0
21,8,61,5,9,66.0,170,1,29,231,Italy,56,-1.5030615104679597,-0.2585170291959301,0,0,1
4,10,9,0,1,0.0,17,3,14,26,France,235,-0.4443722100489414,-1.9569284878749158,3,0,2
8,8,0,9,1,0.0,9,2,16,9,US,39,-0.2448939894007525,-0.8195693644671594,3,0,2
5,8,8,0,1,0.0,1,0,13,9,France,69,0.14977658947636896,-1.235569346138744,3,0,2
5,8,1,2,4,80.0,0,0,13,1,France,23,-0.15878940908799796,0.6108820673221205,2,0,1
4,8,0,0,1,0.0,0,0,12,0,Italy,591,1.3419139293825877,0.02525760718026462,1,3,0
4,8,0,0,1,0.0,0,0,12,0,UK,210,1.3419139293825877,0.02525760718026462,1,3,0
10,8,0,2,1,0.0,0,0,18,0,Spain,626,0.7455129243941837,0.6787938795803703,1,3,0
6,10,45,2,1,0.0,1,3,16,46,France,45,-0.8209591869809386,-1.5036542387423137,3,0,2
5,8,0,0,1,0.0,0,0,13,0,France,638,1.2296015562652727,0.131225121925935,1,3,0
9,10,27,2,2,100.0,6,1,19,33,France,13,-1.5024485935689653,-0.128796671402851,0,0,1
123,8,1,117,86,100.0,0,0,131,1,US,55,-1.24391995291431,1.9650752512104521,2,0,1
73,27,104,8,69,98.0,182,115,100,286,France,11,-2.3314620246171986,-0.18294696163568466,0,0,1
6,8,32,0,4,75.0,23,0,14,55,Austria,174,-0.5202882667551606,-0.3598948190527568,3,0,1
20,22,4,0,6,66.0,235,25,42,239,France,219,-1.6403694330446688,-0.7670663574696321,0,0,1
7,11,4,0,1,0.0,15,1,18,19,UK,590,-0.6182181705310646,-1.716088493863825,3,0,2
3,9,24,0,1,0.0,4,1,12,28,France,83,0.10533503221247792,-2.4241600770136826,3,0,3
3,8,1,1,1,0.0,0,0,11,1,UK,11,0.9171825830380879,-1.020796587464769,3,0,3
11,8,0,4,1,0.0,0,0,19,0,US,560,0.7026506708727105,0.7249980584187834,1,3,0
6,13,36,0,2,0.0,2,0,19,38,US,346,-0.6893344736296203,-0.7430148075363803,0,0,2
20,8,0,4,2,100.0,0,0,28,0,Belgium,181,-0.021332605666112028,2.1001467998528236,2,3,0
8,8,1,0,2,100.0,0,0,16,1,Germany,81,-0.21667328387959184,0.7372983560764929,2,0,1
3,8,0,0,2,100.0,0,0,11,0,France,585,1.230865903815774,0.7406600157047611,1,3,3
4,8,4,0,1,0.0,0,0,12,4,France,107,0.6087700080331391,-0.8562572957047052,3,0,2
12,8,2,1,1,0.0,0,0,20,2,Germany,17,0.003673064700126994,-0.13881466979723325,3,0,2
3,8,0,1,3,0.0,0,0,11,0,France,96,1.3050082013089648,0.35830474828912956,1,3,3
6,8,1,2,3,66.0,0,3,14,1,UK,40,-0.5041336860093677,0.12909387100166023,2,0,1
16,8,0,2,3,100.0,0,0,24,0,UK,21,0.02271417384193872,2.0689875122041377,2,3,0
7,8,0,3,3,100.0,0,0,15,0,US,423,0.2397348142076853,1.8676864678352068,2,3,0
9,8,0,3,2,100.0,0,0,17,0,US,47,0.17496380229556366,1.9128873054134536,2,3,0
31,28,57,2,6,50.0,0,0,59,57,France,226,-1.2627628158276327,0.7799672076829408,0,0,1
11,9,18,11,6,85.0,18,0,20,36,France,11,-1.1689241514873456,0.19912657522333668,0,0,1
36,41,89,35,23,86.0,128,1,77,217,Hong Kong,11,-2.163507839905323,-0.10733678510628673,0,0,1
5,8,0,1,2,0.0,0,0,13,0,France,152,0.7290638792063077,0.9675359727711375,1,3,0
9,8,2,3,1,0.0,0,0,17,2,US,73,0.06055819828136499,-0.1838965944505241,3,0,2
11,8,0,0,4,0.0,0,0,19,0,France,96,0.6616801000687822,0.9709950832365293,1,3,0
5,0,0,0,1,0.0,0,0,5,0,UK,621,2.438735218284603,0.07649590508851349,1,1,2
5,8,1,3,4,100.0,4,1,13,5,US,22,-0.9493733970568997,-0.05824271016293402,0,0,1
21,8,0,23,13,84.0,0,0,29,0,US,11,0.004834602424270068,1.9707855405341719,2,3,0
7,8,112,0,1,0.0,61,2,15,173,Germany,25,-0.4691296929537037,-1.87935251098376,3,0,2
18,9,180,5,2,100.0,58,18,27,238,Netherlands,13,-1.811996529610027,-0.22777400594873146,0,0,1
4,8,0,1,1,0.0,0,0,12,0,Belgium,382,1.1139907924539865,0.32617658051470155,1,3,0
3,8,0,1,2,100.0,0,0,11,0,France,183,1.0029427668871729,1.0415789890391978,2,3,3
5,8,8,9,1,0.0,0,0,13,8,Germany,11,0.1917157895592617,-0.41960545113182424,3,0,2
3,8,1,0,3,100.0,2,5,11,3,Germany,260,-0.10537601710737732,-1.0712463596217472,3,0,3
3,8,0,0,1,0.0,0,0,11,0,UK,147,1.8211872325051175,-0.5087243978983353,1,3,3
7,8,0,0,3,66.0,0,0,15,0,Monaco,125,0.6394881116780605,1.2009368509389091,2,3,0
7,16,82,0,1,0.0,44,16,23,126,France,18,-0.9271407515034373,-1.936550684750053,3,0,2
39,17,474,66,41,87.0,17,0,56,491,Chypre,11,-1.86874177705947,0.4012891390388894,0,0,1
3,8,0,0,1,0.0,0,0,11,0,Swiss,687,1.8211872325051175,-0.5087243978983353,1,3,3
5,8,2,0,1,0.0,0,0,13,2,Netherlands,356,0.5248746235617314,-0.716174364334947,3,0,2
3,8,0,4,5,80.0,0,0,11,0,France,17,1.0855941008615786,0.8193915098537636,1,3,3
6,9,14,1,1,0.0,34,12,15,48,France,259,-0.7841340100426961,-1.6235554852939005,3,0,2
4,8,0,6,4,100.0,1,8,12,1,France,16,-0.5061641354312588,0.2465451322567795,0,0,1
9,8,0,1,4,100.0,0,0,17,0,Italy,29,0.1713552592952166,1.9340881449247689,2,3,0
7,8,2,8,9,66.0,0,0,15,2,France,39,-0.37316762013832433,0.7822753273597012,2,0,1
13,8,0,1,7,85.0,0,0,21,0,Italy,109,0.19703137658330844,1.7417336768117664,2,3,0
5,8,1,0,1,0.0,0,0,13,1,France,568,0.553520043726845,-0.6817660409749365,3,0,2
4,8,11,9,1,0.0,4,2,12,15,UK,40,-0.3315780858698327,-1.5358006127562212,3,0,2
7,8,4,0,15,53.0,0,0,15,4,Italy,78,-0.14428652118481192,0.41812551456092545,2,0,1
12,8,15,8,4,75.0,6,0,20,21,France,11,-0.945988364992285,0.2930714553790097,0,0,1
11,11,385,3,8,100.0,39,3,22,424,Italy,13,-1.8362784304553394,-0.239372838956158,0,0,1
9,9,0,0,4,25.0,0,0,18,0,Spain,26,0.36862845786636594,1.2219307814647646,2,3,0
10,8,4,5,3,100.0,1,0,18,5,Italy,70,-0.9354091724668998,0.6507899648194868,0,0,1
6,8,2,0,2,100.0,0,0,14,2,France,377,-0.1397560102542428,0.6034806969377654,2,0,1
7,8,0,0,1,0.0,0,0,15,0,UK,158,1.0955486418094456,0.25771400110501996,1,3,0
32,8,1,4,19,100.0,0,0,40,1,Italy,11,-0.8909954996650726,1.5460283712886411,2,0,1
5,8,22,1,1,0.0,0,0,13,22,France,47,0.1951473905862917,-0.5376264686777321,3,0,2
6,8,13,0,1,0.0,3,1,14,16,France,13,-0.2311569461341147,-1.703372582993739,3,0,2
13,8,0,0,4,75.0,0,0,21,0,UK,98,0.44671682738061075,1.3966887103396985,2,3,0
6,8,30,2,1,0.0,6,0,14,36,Italy,21,-0.25551377610030046,-0.9606601535690583,3,0,2
6,8,221,42,5,100.0,1,0,14,222,Italy,13,-1.0294149891621918,0.3577019523458178,0,0,1
4,8,40,0,2,100.0,9,4,12,49,France,165,-0.7319156357598013,-0.7655336174776226,0,0,1
5,9,5,5,3,0.0,1,0,14,6,Italy,17,-0.6006906019644858,-0.33733765015978434,0,0,2
3,8,3,2,1,0.0,4,2,11,7,UK,19,0.22547454926836585,-2.0651525754956146,3,0,3
4,8,4,1,1,0.0,11,0,12,15,UK,20,-0.0009258852639370693,-1.0917815899266154,3,0,2
11,9,14,3,24,87.0,0,0,20,14,Italy,14,-0.7886602817609271,0.8019207468906233,2,0,1
8,8,36,0,4,50.0,2,0,16,38,France,101,-0.5727185824785687,-0.21044549235925186,0,0,1
18,19,17,0,2,0.0,1,0,37,18,Spain,16,-0.926141886598121,-0.4582059150874739,0,0,2
13,9,0,10,3,66.0,186,15,22,186,Spain,14,-1.1837697782306063,-0.056988002691609876,0,0,1
30,8,2,4,1,0.0,0,0,38,2,France,382,-0.23652744976331658,0.09775371245392228,3,0,2
4,8,2,0,1,0.0,0,0,12,2,US,466,0.6371869966790464,-0.8221418790806172,3,0,2
3,8,2,0,1,0.0,0,0,11,2,UK,18,1.1164602998015751,-1.356123884159217,3,0,3
39,77,29,2,13,76.0,0,0,116,29,Italy,36,-1.4008938133674746,0.9363867781502352,0,0,1
8,9,4,3,5,60.0,0,3,17,4,UK,24,-0.8807464718022314,0.1424285796855756,0,0,1
3,8,44,0,2,0.0,2,0,11,46,France,14,0.3788750041216237,-1.4503853693462458,3,0,3
6,8,0,1,1,0.0,0,0,14,0,France,46,0.9273691142100404,0.502414742929988,1,3,0
8,8,0,0,1,0.0,1,1,16,1,Spain,646,0.12070511099665344,-1.0613253103647646,3,0,2
7,19,0,0,1,0.0,16,0,26,16,France,181,-0.15453329141482403,-0.7536046445208758,3,0,2
47,56,1,23,21,85.0,0,0,103,1,Romania,11,-1.3254357609280787,1.2409754748538586,0,0,1
4,9,17,0,1,0.0,7,4,13,24,France,24,-0.3434416931039848,-1.9751464479555587,3,0,2
4,11,0,0,3,0.0,7,0,15,7,Spain,174,-0.09088256867885157,-0.3437217904449448,3,0,1
6,9,87,3,1,0.0,5,3,15,92,Germany,15,-0.8094034474086891,-1.5741607786260496,3,0,2
22,9,0,4,8,87.0,0,0,31,0,Netherlands,15,-0.12056312923575979,1.8213836349925245,2,3,0
3,8,0,0,1,0.0,0,0,11,0,UK,177,1.8211872325051175,-0.5087243978983353,1,3,3
5,13,2,0,1,0.0,103,6,18,105,Germany,17,-0.6987613002103076,-1.9133680861930389,3,0,2
7,8,3,0,1,0.0,0,0,15,3,Romania,425,0.3746753570274382,-0.6090755004777303,3,0,2
6,10,0,0,1,0.0,0,1,16,0,UK,688,0.5986680031058377,-0.32547784726983,1,3,0
3,8,0,0,1,0.0,2,1,11,2,France,319,0.8679163242183189,-1.9027634169657242,3,0,3
7,8,0,0,1,0.0,0,0,15,0,UK,397,1.0955486418094456,0.25771400110501996,1,3,0
7,9,1,0,1,0.0,0,0,16,1,Germany,472,0.2211870440121615,-0.6069596934926684,3,0,2
5,8,3,0,2,0.0,1,0,13,4,Denmark,57,-0.08607447403070388,-0.6561217489201039,3,0,2
41,9,16,8,6,100.0,3,0,50,19,Germany,15,-1.533058850212773,0.8438750320055689,0,0,1
8,18,122,3,1,0.0,33,0,26,155,Grèce,11,-0.9272051224163981,-1.0121414500556878,0,0,2
5,11,9,1,2,100.0,10,0,16,19,France,17,-1.0916302119949788,0.23098250817843907,0,0,1
3,8,0,2,3,66.0,0,0,11,0,Denmark,42,1.1238855459231616,0.7530007422399317,1,3,3
26,8,11,1,5,60.0,0,0,34,11,Italy,14,-0.7081238948675354,0.9130755809293062,2,0,1
6,9,31,0,1,0.0,0,1,15,31,Italy,16,-0.14338538938577852,-1.3186400670604745,3,0,2
3,8,0,0,1,0.0,0,0,11,0,France,272,1.8211872325051175,-0.5087243978983353,1,3,3
5,10,0,0,1,0.0,0,0,15,0,Italy,292,0.9210406923879934,0.10803644771039571,1,3,0
6,8,13,0,7,57.0,2,1,14,15,Spain,13,-0.7037741356780839,-0.7021677130465237,0,0,1
29,8,29,0,2,0.0,0,0,37,29,France,17,-0.3544439544217107,0.14636862166234468,3,0,1
4,8,0,0,1,0.0,0,0,12,0,US,586,1.3419139293825877,0.02525760718026462,1,3,0
31,8,6,0,1,0.0,0,0,39,6,France,318,-0.03312544016848486,-0.28631563503051105,3,0,2
9,8,1,1,12,91.0,5,0,17,6,UK,358,-0.7786110560291651,0.35308240529826485,0,0,1
40,8,0,1,14,78.0,0,0,48,0,France,282,-0.06762362162866228,2.0113888926576005,2,3,0
5,8,4,0,1,0.0,0,0,13,4,US,397,0.49645763491582406,-0.7502897809590352,3,0,2
7,9,1,2,1,0.0,0,0,16,1,Swiss,644,-0.02005411243840856,-0.28845740318829066,3,0,2
10,9,3,0,1,0.0,1,1,19,4,US,47,-0.5094206575910022,-1.512317677356782,3,0,2
10,10,9,0,4,75.0,4,0,20,13,Canada,103,-0.8435406459588467,-0.15090270818373322,0,0,1
3,8,0,1,1,0.0,0,0,11,0,France,172,1.5932640955765158,-0.20780542456389847,1,3,3
7,8,0,6,2,100.0,0,0,15,0,Sweden,33,0.23904985772018444,1.8585232313506133,2,3,0
3,8,1,2,2,0.0,0,0,11,1,Italy,338,0.6312500233857556,-0.46782139298406294,3,0,3
6,8,5,0,1,0.0,30,4,14,35,France,125,-0.29616034991759943,-1.806261509634141,3,0,2
34,8,3,3,11,90.0,3,0,42,6,Sweden,14,-1.128028256512122,0.6557489279185633,0,0,1
14,13,94,3,3,66.0,44,10,27,138,US,11,-1.703494340441001,-0.5469152751435591,0,0,1
6,8,3,4,2,100.0,0,0,14,3,Italy,12,-0.41308288250612013,0.9236371582706233,2,0,1
13,10,1,3,13,76.0,0,5,23,1,France,11,-1.0504965210178245,0.36842576683671185,0,0,1
33,8,3,3,3,0.0,0,0,41,3,UK,121,-0.5555346072268103,0.6559983866643309,2,0,1
10,9,23,2,3,66.0,3,0,19,26,US,65,-1.0400062171829303,0.11225792218347669,0,0,1
30,0,6,1,2,100.0,9,10,30,15,Netherlands,17,-0.7340622608756388,0.46597548617172535,2,2,2
7,8,157,3,1,0.0,1,6,15,158,UK,11,-0.6818936959401445,-1.5031431988139587,3,0,2
5,8,1,11,6,100.0,0,0,13,1,France,11,-0.35576002028709736,1.0130174281400424,2,0,1
4,8,20,0,2,100.0,6,7,12,26,Germany,131,-0.7019323035361489,-0.7346198804638646,0,0,1
31,9,0,0,1,0.0,0,0,40,0,UK,367,0.5443046234074541,0.5411755587397338,1,3,0
7,8,0,0,1,0.0,0,0,15,0,UK,708,1.0955486418094456,0.25771400110501996,1,3,0
4,8,4,0,1,0.0,0,0,12,4,Italy,33,0.6087700080331391,-0.8562572957047052,3,0,2
27,9,55,2,5,100.0,0,0,36,55,Serbie,16,-1.133084473634702,1.1117671894854426,0,0,1
5,8,0,0,1,0.0,0,0,13,0,France,246,1.2296015562652727,0.131225121925935,1,3,0
5,8,0,0,1,0.0,0,0,13,0,Germany,600,1.2296015562652727,0.131225121925935,1,3,0
14,8,22,6,13,61.0,2,2,22,24,Netherlands,25,-1.2834988838225587,-0.11606519872201339,0,0,1
3,8,0,0,2,0.0,0,0,11,0,Italy,666,1.5485726923747531,0.026667479612430312,1,3,3
34,16,35,28,24,84.0,1,0,50,36,Italy,11,-1.6014104163167109,0.5584754240640263,0,0,1
6,9,12,1,1,0.0,1,0,15,13,France,80,-0.37667366980569617,-0.9267532315570578,3,0,2
9,8,1,19,12,91.0,0,0,17,1,Spain,14,-0.4669026747593114,0.9660183381813198,2,0,1
15,8,0,21,11,100.0,0,0,23,0,France,11,-0.059161554579359496,2.209587551526136,2,3,0
167,8,2,19,170,99.0,0,0,175,2,Monaco,12,-1.2157335897581847,1.7445244247792258,2,0,1
4,8,0,0,1,0.0,0,0,12,0,France,12,1.3419139293825877,0.02525760718026462,1,3,0
6,8,6,1,2,100.0,5,1,14,11,UK,375,-1.0330572240405718,-0.1354040406046681,0,0,1
10,8,0,17,4,100.0,0,0,18,0,US,23,0.08116938130820149,2.0423438487425343,2,3,0
20,8,1,2,9,77.0,0,0,28,1,Italy,180,-0.5858702198795516,1.0370523519393384,2,0,1
5,9,12,0,2,0.0,1,0,14,13,France,20,-0.3565367650758619,-0.7547125026367635,3,0,2
6,8,0,0,1,0.0,0,0,14,0,Italy,602,1.1552922511386414,0.2014957695955512,1,3,0
12,8,0,0,10,100.0,0,0,20,0,France,71,0.2921480057657425,1.7628145604761474,2,3,0
30,8,79,0,1,0.0,3,0,38,82,Japon,11,-0.47979150841648616,-0.9153350545309478,3,0,2
5,8,0,0,1,0.0,0,0,13,0,France,138,1.2296015562652727,0.131225121925935,1,3,0
4,8,3,0,1,0.0,0,0,12,3,France,481,0.6210406446005802,-0.8415318944024861,3,0,2
5,8,138,1,2,100.0,54,6,13,192,Belgium,14,-1.1829041877109348,-0.5035137192736745,0,0,1
4,8,0,0,1,0.0,0,0,12,0,UK,509,1.3419139293825877,0.02525760718026462,1,3,0
4,7,0,0,1,0.0,0,0,11,0,France,71,1.74043273682626,0.04366242493702348,1,3,2
23,8,4,2,2,100.0,0,0,31,4,Netherlands,11,-0.7697565639513717,1.227238042226305,2,0,1
12,8,11,0,13,92.0,2,2,20,13,Italy,13,-0.9632817063225715,-0.43273809557544834,0,0,1
30,8,0,6,7,83.3,0,0,38,0,France,13,-0.030640627653581696,1.9685895927683028,2,3,0
5,9,77,2,3,66.0,3,6,14,80,Hong Kong,11,-1.1891551424525515,-0.7080096892164124,0,0,1
5,8,0,0,2,100.0,0,0,13,0,France,75,0.63928022757593,1.3806095355290309,2,3,0
19,14,175,0,4,0.0,107,5,33,282,Denmark,201,-1.4063207429073041,-1.2241561345854204,0,0,1
9,8,0,0,1,0.0,0,0,17,0,Romania,83,1.0151362757601365,0.3336331340255292,1,3,0
9,8,2,10,12,84.0,0,0,17,2,Belgium,11,-0.4769332164773602,0.9027546507349529,2,0,1
19,13,56,0,3,100.0,3,11,32,59,Germany,12,-1.5787973052940731,-0.3809389074680821,0,0,1
9,9,4,0,1,0.0,0,1,18,4,Luxembourg,309,-0.17184164454058426,-1.097156402101918,3,0,2
16,8,1,4,15,100.0,757,31,24,758,Germany,42,-1.6581336846093961,-0.04832987695222425,0,0,1
3,8,0,0,1,0.0,0,0,11,0,Austria,118,1.8211872325051175,-0.5087243978983353,1,3,3
25,10,7,0,1,0.0,0,1,35,7,Italy,12,-0.4760313308939276,-0.9268638427445967,3,0,2
5,8,0,6,4,100.0,0,0,13,0,Spain,13,0.34756622132903564,1.7821859761332344,2,3,0
4,8,1,0,1,0.0,0,0,12,1,France,174,0.6658324168441601,-0.7877335557206065,3,0,2
4,8,6,2,2,100.0,1,0,12,7,Italy,15,-0.5586753313118991,0.23930505207046562,2,0,1
5,8,0,0,1,0.0,6,1,13,6,France,603,0.23789070060015732,-1.313344326620003,3,0,2
13,8,0,15,10,100.0,3,0,21,3,France,14,-0.7153592869915293,1.2373344058065545,2,0,1
6,9,0,0,1,0.0,0,4,15,0,Germany,508,0.6554720875732136,-0.37282573666990587,1,3,0
26,9,27,2,2,100.0,6,3,35,33,Sweden,28,-1.6898358547055115,0.06877588627382716,0,0,1
6,9,2,4,17,76.0,0,0,15,2,Italy,18,-0.5311090869954634,0.7125948509716469,2,0,1
65,157,792,2,3,0.0,707,18,222,1499,Ukraine,11,-2.2919275142268316,-0.9046639200535892,0,0,1
28,8,0,0,1,0.0,0,0,36,0,France,620,0.7468681622483146,0.5858059299598097,1,3,0
30,9,21,1,1,0.0,0,0,39,21,UK,76,-0.47784746942450085,-0.13415226243767123,3,0,2
4,8,0,0,2,50.0,0,0,12,0,France,315,0.9052022109755525,0.9294302747231757,1,3,0
8,8,24,1,7,100.0,0,0,16,24,France,28,-0.6214440817304883,0.9599035592841303,2,0,1
8,8,3,0,2,100.0,0,1,16,3,UK,33,-0.5291018777641967,0.19589753389046383,2,0,1
13,9,52,0,7,85.0,1,4,22,53,France,46,-1.209531864873129,-0.6300965138188447,0,0,1
3,8,0,0,1,0.0,0,0,11,0,UK,395,1.8211872325051175,-0.5087243978983353,1,3,3
5,8,2,0,1,0.0,0,0,13,2,Italy,660,0.5248746235617314,-0.716174364334947,3,0,2
6,8,5,0,1,0.0,0,0,14,5,US,690,0.4133266650226429,-0.6906238717451827,3,0,2
30,8,0,4,3,100.0,0,0,38,0,Italy,80,-0.1377631998863054,2.2252559076601623,2,3,0
6,8,0,1,1,0.0,0,0,14,0,UK,18,0.9273691142100404,0.502414742929988,1,3,0
3,8,1,0,1,0.0,0,0,11,1,Italy,628,1.145105719966689,-1.3217155607992064,3,0,3
6,8,0,1,1,0.0,0,1,14,0,Austria,116,0.6597322925690154,0.014812259425838305,1,3,0
57,11,26,55,31,100.0,3,0,68,29,Bulgaria,11,-1.8069539235541483,1.024524945516241,0,0,1
6,8,0,9,8,100.0,0,1,14,0,US,24,-0.0250230236432961,1.4184941314627086,2,3,0
4,8,2,1,3,100.0,0,0,12,2,France,19,-0.19669882307608574,0.7588798031991787,2,0,1
6,8,0,3,1,0.0,0,0,14,0,Spain,11,0.9054411063634118,0.5313655273803796,1,3,0
5,8,1,0,1,0.0,0,0,13,1,Italy,13,0.553520043726845,-0.6817660409749365,3,0,2
30,8,7,6,48,35.0,0,0,38,7,Bulgaria,43,-0.8344588260388405,1.1508449977817667,2,0,1
11,10,0,1,2,100.0,1,0,21,1,Portugal,22,-0.7646258550239,0.985244310412616,0,0,1
33,9,6,0,5,80.0,0,0,42,6,France,15,-0.6945466729685918,0.6395369542909917,2,0,1
3,8,5,1,1,0.0,1,0,11,6,France,11,0.53129808371059,-1.553173905045547,3,0,3
7,10,11,2,1,0.0,0,0,17,11,US,15,-0.1898578215971039,-0.40834881630898495,3,0,2
21,9,0,1,4,50.0,0,1,30,0,France,119,-0.3141443560009712,1.2155069831995287,2,3,0
3,8,7,0,1,0.0,1,0,11,8,Swiss,13,0.7458761085301491,-1.8701179118533784,3,0,3
4,8,0,0,2,0.0,0,0,12,0,UK,127,1.0692993892522245,0.5606494846910298,1,3,0
28,9,15,1,2,100.0,0,1,37,15,UK,126,-1.2999800761660893,0.6289107310980221,0,0,1
7,8,5,4,4,100.0,0,0,15,5,France,17,-0.5194553440162828,1.004676873983815,2,0,1
31,0,17,0,1,0.0,0,0,31,17,France,125,0.7060126833752762,-0.043029878701514146,3,2,2
7,8,6,0,4,100.0,2,1,15,8,UK,266,-0.8703509439333788,-0.3025853440160241,0,0,1
3,9,0,0,1,0.0,0,0,12,0,Italy,323,1.5244381286479023,-0.47899706626558697,1,3,3
9,10,62,8,9,100.0,10,1,19,72,France,15,-1.634949056114357,-0.04995021121022766,0,0,1
11,8,0,6,13,92.0,1,0,19,1,Sweden,71,-0.48446241346941304,0.9281281230541298,2,0,1
5,9,13,0,1,0.0,24,5,14,37,France,43,-0.4613289942664211,-1.9394352907418873,3,0,2
17,10,81,20,20,100.0,80,9,27,161,Austria,11,-1.918690116051714,0.0022412498834195158,0,0,1
8,9,29,25,20,92.8,0,1,17,29,Netherlands,14,-1.058395596661725,0.26115157761372515,0,0,1
4,8,0,0,1,0.0,0,0,12,0,France,694,1.3419139293825877,0.02525760718026462,1,3,0
3,8,0,1,1,0.0,0,0,11,0,France,244,1.5932640955765158,-0.20780542456389847,1,3,3
11,8,9,0,2,0.0,6,1,19,15,Spain,26,-0.700935155933429,-0.9885803162035711,0,0,1
31,10,521,3,2,0.0,159,17,41,680,Portugal,11,-1.7375235993539395,-0.9525532935428891,0,0,1
3,8,2,0,2,0.0,4,0,11,6,UK,84,0.4847212695587827,-1.3261466007342668,3,0,3
21,9,3,20,27,85.0,0,0,30,3,Italy,11,-0.9058468739445635,1.0686655325732604,2,0,1
3,8,0,1,1,0.0,0,0,11,0,France,133,1.5932640955765158,-0.20780542456389847,1,3,3
31,7,14,3,1,0.0,9,1,38,23,Grèce,17,-0.6756790937919679,-0.8767738836919413,3,0,2
54,8,5,102,63,98.0,3,0,62,8,US,293,-1.3803729231232065,0.9486421954926572,0,0,1
5,8,0,0,1,0.0,0,0,13,0,UK,706,1.2296015562652727,0.131225121925935,1,3,0
3,8,3,0,1,0.0,8,2,11,11,France,191,0.44707850608692196,-2.4098353399179375,3,0,3
11,9,1,0,1,0.0,0,0,20,1,Italy,684,0.10137822552634444,-0.49237467186090045,3,0,2
107,3649,310,217,70,98.0,0,0,3756,310,France,11,-2.797790833229904,1.4324089816372123,0,0,1
